text	label
Hi, this is Joe Last and I would like to pay my auto insurance bill.	PayBill
So what is my payment?	CheckAccountBalance
I need to file a car accident claim.	FileClaim
yes I need to pay my bill.	PayBill
Yeah it's fine. Last night I tried filing a claim online on your website, it wasn't successful so that's the reason I'm calling right now.	FileClaim
Yes I am, thanks. I need you to guide me throught the step by step procedure of filing a claim.	FileClaim
my office requested I get a proof of insurance from my provider. Would that be possible?	RequestProofOfInsurance
Hi Rebecca, it's Brad. I called earlier to make enquiries about getting my kids added to my policy plan.	AddDependent
Thank you Michelle. I need some guidiance with getting a claim filed.	FileClaim
my kids were all dependents of my late husband's policy. I would like to change that and make them dependents of my insurance policy.	AddDependent
my credit card recently got expired. I wanna update my payment preference.	UpdatePaymentPreference
Yes I'm gonna need an auto quote.	GetQuote
I recently moved to a new apartment and the property owner has requested a proof of insurance.	RequestProofOfInsurance
No but I don't mind creating an account right away so I get the proof of insurance.	CreateAccount
Yes please. Could you please sign me up?	EnrollInPlan
Hi Ann, so my friend just referred Rivertown Insurance to me saying y'all got great customer service because my current insurance company has got really shitty customer service and honestly I'm done with them. Please sign me up I wanna get insured.	EnrollInPlan
For the auto and health plan.	EnrollInPlan
been noticing multiple debit transactions on my account and I'm starting to think I'm being ripped off.	ReportBillingIssue
I noticed multiple debit transcations last months and I also got multiple debit transactions earlier today so I am no longer interested in the automatic billing.	CancelAutomaticBilling
Well I just got a new cat and I'm thinking about getting her insured. Can I do that?	EnrollInPlan
Hi I would like to create an account and also enrol for an insurance plan.	CreateAccount
I wanna enrol for the life insurance. I could also get an auto quote forwarded to me so I check that out for a later time.	EnrollInPlan
And how much for the term life insurance?	GetQuote
I think I'm gonna opt for the universal life plan.	EnrollInPlan
Can I get a quote for the petcare preferred plan.	GetQuote
I should actually take this opportunity and open up an account.	CreateAccount
Hello, I'd like to set up a new account with you guys.	CreateAccount
Yeah I'd like to set up an account for auto insurance.	EnrollInPlan
Hi Anthony, my name is Brianna. I'm calling bacause I recently moved out of my previous residence and I wanna change my address so I don't get my mails sent over there.	ChangeAddress
One last thing. My landlord has requested for a proof of insurance.	RequestProofOfInsurance
as a matter of fact there is something you can do. I need to file a claim for my home, you can make it as smooth as possible. I'd appreciate that.	FileClaim
So yeah I wanna cancel my auto policy plan.	CancelPlan
Hi, I just got involved in an accident and I wanna file an auto claim.	FileClaim
Hi I wanna get a howeowners quote.	GetQuote
I'm kinda leaning towards the home complete plan.	EnrollInPlan
Okay. Sign me up.	CreateAccount
So what have I gotta do to get my dependent added to my account?	AddDependent
Hi Anna, my name is Robert. I recently got a new apartment and I wanna get more information about a renters insurance and get a renters quote.	GetQuote
Okay then. Sign me up.	CreateAccount
Hi Curtis, I'm Josh. I called earlier in regards to a condo quote.	GetQuote
Yeah I got time on my hands right now. Let's get it done.	EnrollInPlan
you know what I think Ill just do the basic for both and if I feel like I need to change it later, can I just call you guys, and have it switched?	EnrollInPlan
It's the password, I think I need to reset it.	ResetPassword
Finally got someone jeez. Yeah. My name is John Brown, policy number one two three four five six seven eight and I need to cancel my plan.	CancelPlan
Hi Rachel, I'm calling because I want to cancel my insurance plan with you guys.	CancelPlan
Hi Rachel, I'm calling because I want to cancel my insurance plan with you guys.	CancelPlan
yeah, I need to change my address, we recently moved a few blocks over.	ChangeAddress
Hi, Anna. We just moved and I need to make sure our bills come to the new place.	ChangeAddress
Hi, Mike. Um, I need insurance for my dog.	EnrollInPlan
Gabe, hi, my name is Sam. I need to, uh, find out how much it costs to get insurance for my dog.	GetQuote
Uh, yeah, my account got hacked. It's a mess. My payment comes out on the second and there's nothing in there right now. I've got to stop the payment from coming out.	CancelAutomaticBilling
Yeah, I just realized I've never paid you any other way. How does this work?	UpdatePaymentPreference
Oh, okay. This is Grant Baker. I thought I paid you guys but now I've got this bill for twice the amount I should owe.	ReportBillingIssue
uh, yeah, I'm on your website and I can't log in for some reason. I don't know what's going on.	ResetPassword
Hi Gladys, uh, I need to get a quote from you on some insurance.	GetQuote
Sounds like you've been in an accident. How can I help?	ReportAutomobileAccident
Okay, I've got your policy pulled up here. Do you need me to email it to you?	RequestProofOfInsurance
Hi, I need to cancel my plan with you guys.	CancelPlan
Yes, I need some proof of insurance for my, car.	RequestProofOfInsurance
I, I'm thinking of getting pet insurance and wanted to get a quote. Kinda feeble, huh?	GetQuote
Yes I recently filed for divorce and I need to remove my husband from my health insurance.	RemoveDependent
Yes I'm trying to get a new apartment and they require proof of renter's insurance. Is there anyway I can get that sent to them.	RequestProofOfInsurance
Yeah. You guys are overbilling my account and I'm sick of it. You need to fix it.	ReportBillingIssue
Hey there my name is Cindy Peebles and I have been a customer for years and I need to change my address and I've never had to do that before so I don't know how.	ChangeAddress
Hello. I need to remove someone from my plan.	RemoveDependent
Been reading all about this climate upping. I-I think the waters might decide to visit the house. So I need to add water protection to my homeowners policy.	ChangePlan
Hey yes I just recently moved to a different place and need to change my address and phone number that I have with you guys.	ChangeAddress
Perfect. Can I get a quote for that? I'm already a customer with you guys and have nothing but good experiences.	GetQuote
Hey yes I mailed my bill about a week ago and I haven't seen it get credited to my account and I just want to check on that.	CheckPaymentStatus
Hey I'm trying to organize my hurricane kit and I realized I don't have my policy number for you guys. Can you provide that for me?	GetPolicyNumber
Just a reminder, your bill is due tomorrow. Would you like to go ahead and pay it while you're on the phone with me?	PayBill
Yes my name is John Brown, policy number one two three four five six seven eight and I need to report an accident.	ReportAutomobileAccident
Yes I need to update some of my security information on here. I think someone got ahold of my info and is trying to pretend to be me.	ChangeSecurityQuestion
Hey yes I have a renewal coming up and I usually pay only once a year but this year I can't make one large payment. I need to see if I can do it monthly.	UpdateBillingFrequency
Hey I got several policies with you guys but I saw online that you offer pet insurance. Can you tell me how much that costs?	GetQuote
Yeah my name is Ricky Johnson and I'm customer there. I haven't had access to a computer in a while and I need to see when my bill is due and make a payment.	PayBill
Hey I was wondering if I could get a quote for car insurance. My friend uses you guys and had some good things to say. I'm trying to lower my premiums.	GetQuote
I'm an idiot and thought I could remember my password but apparently I can't. I believe it locked me out because I tried too many passwords.	ResetPassword
Yes. I just recently got married and I've been with you guys for years so I'd thought I'd add my new husband as a dependent.	AddDependent
Great. Can I go ahead and pay that now?	PayBill
Yeah I'm at the DMV and I'm trying to register my car but they need proof of insurance so I guess I need you to send me a copy.	RequestProofOfInsurance
Not a problem. I'd be happy to help. I'm assuming you need to change your address?	ChangeAddress
Yeah I think I'm locked out of my online account I keep trying to log in and it says too many invalid attempts.	ResetPassword
Yeah, my name is Jamie Gresham and I need to see if you got my last payment and ask a question about my coverage.	CheckPaymentStatus
Yes I want to see if I can change my payment from monthly to annually. I keep forgetting to pay it every month.	UpdateBillingFrequency
Hi I got a notice in the mail that if I don't pay my bill you guys are going to cancel my policy so I guess I need to pay it.	PayBill
Yes I recently got married and need to add my husband to my health insurance policy.	AddDependent
Oh! I need to pay my bill and ask a question about auto-pay.	PayBill
Yeah I'm trying to register my car and they need my insurance number and I don't have it.	GetPolicyNumber
How do I get proof of that?	RequestProofOfInsurance
I don't know my password.	ResetPassword
I'm actually looking to change my insurance plan for my family and I.	ChangePlan
Yeah. I'm shopping around for life insurance rates and I wanted to see how you guys compare. I heard a lot of good things about your company from friends.	GetQuote
Yes we just adopted a new baby and I need to add her to my health plan.	AddDependent
Yeah I need to check my account balance.	CheckAccountBalance
Okay. Can you tell me the life insurance now?	CheckAccountBalance
Would you like to go ahead and make a payment?	PayBill
Yes, I need to file a claim. We lost my wife this week.	FileClaim
Yes my name is Carol Brown and I've been a customer with you guys for about six years but I'm afraid someone has my information so I need to change my security question.	ChangeSecurityQuestion
Hey I mailed my check a few days ago to pay you guys and I don't see where it has hit my account. Can you tell me if you see it on your end?	ReportBillingIssue
Yeah I was thinking about upgrading my plan and wanted to talk to someone to see what kind of options I have.	ChangePlan
Yes. I think I've been a victim of identity theft so I need to change my security question for you guys so I can keep my stuff safe.	ChangeSecurityQuestion
Yeah. I think I've accidentally locked myself out of my online account. It's been giving me an error message.	ResetPassword
Yeah I need to go ahead and set up my plan to be cancelled. I've found a better company to cover me.	CancelPlan
Hi, I need to speak to someone about my bill.	ReportBillingIssue
Hey! My name is Kara Turner and I have a few policies with you guys. I just recently moved and so I want to update you guys with my new address.	ChangeAddress
Yeah I have been shopping for car insurance and had saw an ad for you guys and thought I'd see if you could beat the other rates I've got.	GetQuote
Yeah I need to update my address with you guys and pay my bill.	ChangeAddress
Yes. I need to do something about lowering my premiumiss I recently lost my job and just can't afford the payments anymore. I don't want to change companies. I've been with you guys for years.	ChangePlan
How much different is that one?	GetQuote
Hey I currently have life and health insurance with you guys and I recently got a quote for auto insurance that I would like to go ahead and enroll in.	EnrollInPlan
Can I pay it monthly?	UpdateBillingFrequency
Yes I need to check my account balance with you guys. I don't think I've paid my bill this month so I need to make sure.	CheckAccountBalance
Sure!	PayBill
Hello there. I heard you guys do pet insurance and I just thought that was the neatest thing. Do you think I could get a quote on a policy?	GetQuote
Yes my name is Rita Wilson, customer ID one two three four five six seven eight, and I need to add someone to my life insurance plan.	AddDependent
Hey there. I'm shopping around for some condo insurance and was hoping to get a quote from you guys.	GetQuote
Yes I need to file a claim for a doctor visit.	FileClaim
Hi Susan, my name is Jane. I need to add a dependent to my insurance plan.	AddDependent
I'm doing well. So our rep told me that you were interested in signing up for our Complete Auto plan, is that correct?	EnrollInPlan
Great can I pay over the phone?	PayBill
No. I think I want to go ahead with it.	EnrollInPlan
Hi yes. My name is Jasmine Glover and I need to get proof of insurance sent to me.	RequestProofOfInsurance
Hi I got a notice in the mail saying I was past due. I must have forgot to send you guys a check this month. I need to go ahead and fix that if you can help me please.	PayBill
Yeah I think I've locked myself out of my account online. I can't remember the password.	ResetPassword
Yeah I need to cancel automatic payments. You guys have been overcharging me.	CancelAutomaticBilling
Yes. I just need to report it so I can file a claim once I get it cleared.	ReportAutomobileAccident
Yes I need to check the balance on my policy and possibly pay a bill if the payment is due.	CheckAccountBalance
Hi there I need to see if a payment has been credited to my account.	CheckPaymentStatus
Then there's a problem because it already came out of my bank account.	ReportBillingIssue
Yes my house was damaged in the last hurricane and I need to file a claim. I've been a customer for years so I hope it doesn't mess up my rates.	FileClaim
Hi Jane. I'd like to get a quote for insuring my vehicle	GetQuote
Yes, I'm in the market for new homeowners insurance and I wanted to see what you guys could offer me. I've read some good reviews about you guys.	GetQuote
Yeah I can't seem to get logged in online. I've been with you guys for years and this is the first time it's ever given me problemiss It's starting to get on my nerves.	ResetPassword
Good afternoon, Sandra! I got your information from one of our phone reps that stated you were interested in enrolling in one of our auto insurance plans.	EnrollInPlan
Hey I'm working with a local agent and they said I need to call and set up an account so I can finish purchasing my new auto plan.	CreateAccount
Yes I just recently moved and I need to update my address on my policies with you guys.	ChangeAddress
Yes I've heard a lot of good things about you guys from friends and family and I was interested in finding a local agent to talk about signing up for one of your plans.	EnrollInPlan
Hi Jared, we got a notification of an accident that you were in recently and we wanted to go ahead and start the claims process.	FileClaim
Yes my name is John and I've been a customer a while with you guys. I was wondering if I get any discounts from changing my bill from monthly to yearly?	UpdateBillingFrequency
Hey I would like to see if you guys have an agent near me. I've been interested in moving my policies to you guys but I need to know if there's someone close to me.	FindAgent
That's fine. I just really want to find the nearest agent.	FindAgent
Hi. #Um I wanted to get a quote for pet insurance for my puppy.	GetQuote
Hey there, I just need to make a payment.	PayBill
Yes my name is Margaret Johnson. My customer ID is one three two four five six seven eight, and I sent a check in last week and I haven't seen it get credited to my account.	CheckPaymentStatus
Yes I need to cancel my plan with you guys. I was able to find a lower price somewhere else.	CancelPlan
Yes my name is Jack Henry and I need to add someone to my health insurance plan.	AddDependent
Well I need to see how much it would cost me to get insurance on my car. My kids say I can't drive it until I have insurance.	GetQuote
Oh okay that's what I want then. The fifty seven dollar one.	EnrollInPlan
Hi I am a current client of yours and I am looking to change my plan.	ChangePlan
Ok. Let's cancel it out today please. I am going to get my physical done as soon as I can.	CancelPlan
Hi I am looking to find an insurance agent.	FindAgent
Anyway I am looking to get some pet insurance, but I am looking around and have a few questions then want to figure out the total.	EnrollInPlan
Well I am not sure what I am looking to do. I want to change my bill to monthly?	UpdateBillingFrequency
It looks like that is not the address we have on file. Did you recently move?	ChangeAddress
I need to check my account balance.	CheckAccountBalance
Ok. Would you like to pay your monthly bill now?	PayBill
Hi, I need to speak to someone about my policy. I need to have a dependent take off.	RemoveDependent
Hi Sam I am looking to see where my payment status is at.	CheckPaymentStatus
I am having issues with billing.	ReportBillingIssue
While I have you on the phone would you like to pay your bill?	PayBill
Oh hi Jane! I was just calling to get my policy number.	GetPolicyNumber
Well I should probably pay my bill while I have you on the line.	PayBill
Hi Joe. I recently got divorced and I would like to change my security question and answer.	ChangeSecurityQuestion
Yes and my ex husband knows that so I would like to change it.	ChangeSecurityQuestion
Alright I have that updated on my end. One more thought about protection on this account would you like me to remove your ex husband from the account, so he would not be able to have access even if he knew that?	RemoveDependent
Oh hello yes I'm calling I'd like to get my car insured, my 	GetQuote
Well I'm glad to hear that. Okay so I can help you get an account set up with us first and then we can hash out your your insurance plan and all that, does that sound good?	CreateAccount
Yeah thanks, I did some reading and talked with my friend so that's the one I'd like to go with for now.	EnrollInPlan
Yeah, I need to talk to someone about canceling my car insurance.	CancelPlan
Hi. I need to check my bill? And maybe pay my bill?	CheckAccountBalance
A year? Seriously? Yeah, let's definitely switch me.	ChangePlan
Yeah. I was wondering if I could like, prepay? I need to make a big payment and I'm afraid of getting overdrawn on my checking.	PayBill
#Uh, could we actually change that to something else?	UpdateBillingFrequency
I know all that. I just want to be able to change my password.	ResetPassword
Can you tell me what the balance in my account is?	CheckAccountBalance
No, you can't help. I need to cancel my plan.	CancelPlan
Hi Jane. I need to get a quote for a new homeowners policy. Can you do that over the phone?	GetQuote
yeah. I have my current homeowner policy and my auto policy with you guys. I've bought a new house so I need to get a policy on that property. Oh, and I guess I'll need to cancel the one on my house that I sold.	EnrollInPlan
Oh. #Um Hello mister Banes. I'm calling from Rivertown Insurance. I have a- a- note in the file indicating that you would like to add a dependent to your plan.	AddDependent
Well, that's actually why I'm calling. I can't use the car until I arrange the license and insurance.	EnrollInPlan
No, I'm not. My brother-in-law uses you and he suggested I call. He said the your rates are pretty good. I spoke with Debby last week and I liked the quote I was given. I'd like to proceed with creating an account and setting up the insurance.	CreateAccount
So my bank card was stolen and I think that's the card you guys have.	UpdatePaymentPreference
Okay let me try again . I need to pay my bill I just got a new renter's insurance policy with you last month and I need to make my first payment.	PayBill
Currently I have my bills paid automatically but I don't want that anymore. I just can't keep up with what's what very well and this automatic payment stuff just confuses me and I don't really like it. My son used to take care of all of that but he moved away and can't help me as easily so yeah.	CancelAutomaticBilling
#Hmm okay let's do the term life insurance then. You said three hundred for the year?	EnrollInPlan
Hi yes I'm calling to create an account.	CreateAccount
Yes hi Jeff this is Maria Lopez. I have an auto insurance account with Rivertown and I need to update my payment method.	UpdatePaymentPreference
Yes, hello. My name is Karl Atkinson and I called last week about a quote for homeowner's insurance. I would like to follow up on that.	GetQuote
I think I still want to go with the basic plan.	EnrollInPlan
Yes I am and I actually just got a new pet so I'll need two policies I guess.	EnrollInPlan
Yes that would be great.	GetQuote
Great. So I want to sign up for the preferred plan then please.	EnrollInPlan
Can I pay for the whole year up front?	UpdateBillingFrequency
Hello yes I want to check into changing a plan if that's even possible.	ChangePlan
And I actually wanted to inquire about some homeowner's insurance.	GetQuote
Hi Jane. I need to submit a claim. My car was broken into last night.	FileClaim
Yeah hi I'm in a bit of a problem right now. I had a problem with my car and they need my insurance.	RequestProofOfInsurance
Yes hello I just bought a condo and I wanted to see about getting a quote for some insurance.	GetQuote
Yeah yeah no absolutely. So okay you said the preferred in how much?	GetQuote
Hi Mike I need to change my security questions.	ChangeSecurityQuestion
Yes hi I was calling to get a quote for life insurance please oh and to check on the status of my auto insurance.	GetQuote
I wanted to see how much more I owe on my policy.	CheckAccountBalance
Okay then let me get a quote from the other plans then if you don't mind.	GetQuote
#wow #jeez okay well then I should probably get the universal one then.	ChangePlan
No I want to go ahead and keep my term life insurance but add a universal plan since I already paid for the term insurance.	ChangePlan
yeah that the word frequency. I want to change to the frequency of how often I pay to every month.	UpdateBillingFrequency
Yes hi my apartment complex wants something saying I have proof of insurance from you all and I also need to change the card I pay the bill with.	RequestProofOfInsurance
Yes hi hello I'm interested in homeowner's insurance.	EnrollInPlan
Alright so let's talk about price then.	GetQuote
Yes hello I called last week to set up a homeowner's insurance policy and made an initial payment but I forgot what the agent said about accessing my account online and I don't remember how much the bill is so I need to see what my current account balance is and also how to access my account online.	CheckAccountBalance
Yes I need to set my password.	ResetPassword
Yes hello. I have recently taken over financial responsibility of my elderly mother and I'm calling to just check on her account status.	CheckAccountBalance
Great. So I really wanted to check on her payment status and see if she's up to date on all of that.	CheckPaymentStatus
Alright so I will take care of that today then.	PayBill
Hi there, I was calling to get a quote for dog insurance? We just adopeted a little lab from the shelter today.	GetQuote
Yes, hi Amelia. This is Karen Anderson. I have an automobile policy with you and I need to add my son on my policy please.	AddDependent
Oh yes, actually speaking of dependents I need to take my oldest son off of my policy. I completely blanked on that.	RemoveDependent
I need to cancel.	CancelPlan
Yes hi I was calling to get a quote for life insurance please oh and to check on the status of my auto insurance.	GetQuote
Okay then let me get a quote from the other plans then if you don't mind.	GetQuote
No I want to go ahead and keep my term life insurance but add a universal plan since I already paid for the term insurance.	ChangePlan
one. Oh okay yeah then I want to go with that one.	EnrollInPlan
Oh that's good. Excellent. Okay so yeah sorry. I think I called Rivertown last week inquiring about an auto plan and I'd like to enroll in one.	EnrollInPlan
I sure hope so because I'm getting charged a lot more than I should be and my address is slightly wrong as well. Luckily I got the bill though.	ReportBillingIssue
Oh I definitely am interested in that I just haven't gotten around to doing it but I figured that I should still change my address.	ChangeAddress
I need to change my address with you, again.	ChangeAddress
Yes, I was billed twice this month, and I need to see what's going on.	ReportBillingIssue
Okay, right so I've got an automobile policy with you now and I have decided to shop my home insurance.	GetQuote
#Uh, I want to cancel my policy. Is this the right number to do that?	CancelPlan
Okay, right so I've got an automobile policy with you now and I have decided to shop my home insurance.	GetQuote
So do you think you could email me that quote if I give you my email address?	GetQuote
Okay, right so I've got an automobile policy with you now and I have decided to stop a pet basic insurance to it.	GetQuote
yes I subscribed to a policy with Rivertown and I think you could be of help to me to upgrade my current policy.	ChangePlan
So do you think you could email me that quote if I give you my email address?	GetQuote
yes I have an existing policy with Rivertown and I think you could help me delete the account.	CancelPlan
yes I want to change my current plan and I was wondering if you can help me to solve my last name spelling issue?	ChangePlan
So do you think you could email me that quote if I give you my email address?	GetQuote
So do you think you could email me that quote if I give you my email address?	GetQuote
Hi I am looking to get information about Life insurance.	GetQuote
Hi I am calling because I received a wrong bill.	ReportBillingIssue
I just paid my phone bill two days ago and my payment is not reflected in the bill.	ReportBillingIssue
That reminds me I also need to get a policy number.	GetPolicyNumber
I have an insurance plan with your company. And I wish to opt out from that plan how can I go about it?	CancelPlan
Well, I'm thinking I'd like to get some coverage for my pets today. You do carry pet insurance, right?	EnrollInPlan
Hi there, Brittney. My name is Noah and I yeah, hold on a sec! Sorry. I just need my balance real quick and the automated thing wasn't working, so it transferred me to you.	CheckAccountBalance
No, she is gonna do that one. I guess what it is she wanted was to check on the auto policy for the Durango. Jeez what a mess. I guess she said to check the car payment, oh I mean the insurance. Insurance payment on the Durango, two zero zero four that she sent to ya'll because she said you should have got it there yesterday and wants to know if it cleared the account already.	CheckPaymentStatus
yes I have an existing plans with Rivertown and I was wondering if you could help me cancel automatic billing on my account.	CancelAutomaticBilling
I need to change my address.	ChangeAddress
Can you tell me how much my premiums will change, you know, monthly?	GetQuote
yeah I subscribed to a policy with Rivertown and I think you could be of great assistance in helping me to reset my password?	ResetPassword
Yea Charlton....since I have you online. I would allow you help me recover the password from your system.	ResetPassword
yes I have an existing policy with Rivertown and I was wondering if you could help me with an upgrade from my current home preferred?	ChangePlan
So do you think you could email me that quote if I give you my email address?	GetQuote
I subscribed to a policy with Rivertown and I think you are in a position to help me reset my password?	ResetPassword
yes I have an existing policy with Rivertown and I was wondering if you could help me to create an account.	CreateAccount
#mhm I want to shop a complete auto policy.	GetQuote
yes I subscribed to a policy with Rivertown and I think you could be of help to reset my password?	ResetPassword
I want to cancel my insurance plan.	CancelPlan
yeah I subscribed to a policy with Rivertown and I think you could be of great assistance in helping me to reset my password?	ResetPassword
yes I have an existing policy with Rivertown and I will like to upgrade it and i was wondering if you could help me.	ChangePlan
Hello, I want to reset my online account password.	ResetPassword
Hi. I've been trying to reset my online password. I tried so many times that I got locked out! I need to -	ResetPassword
yes I subscribe policy with Rivertown and I think you could help me to reset my password?	ResetPassword
yeah, I have to reset my password?	ResetPassword
Yes i have an existing policy with Rivertown and I was wondering if you could help me get my proof of insurance.	RequestProofOfInsurance
Yea....I wish to upgrade my existing plan so I was wondering if You would be able to do that for me.	ChangePlan
yes I have an existing policy with Rivertown and I was wondering if you could help me get my proof of insurance.	RequestProofOfInsurance
Okay, right so I've got an automobile policy with you now and I have decided to add my pet to my insurance package.	EnrollInPlan
Yea....since I have you online. I would allow you help me recover the password from your system.	ResetPassword
yes I subscribed to a policy with Rivertown and I think you could help me add up to my policy.	ChangePlan
Okay, right so I've got an automobile policy with you now and I have decided to shop a pet basic insurance to it.	GetQuote
Okay, right so I've got an automobile policy with you now and I have decided to shop my home insurance.	GetQuote
yeah, I had a few questions about a Petcare policy. You offer that right?	GetQuote
So do you think you could email me that policy strategies if I give you my email address right away?	GetQuote
Hi, I want to cancel my insurance plan.	CancelPlan
Hey, Jessica. I managed to lock myself out of my account and need to reset my password.	ResetPassword
Hi, good morning. I want to cancel my insurance plan.	CancelPlan
yes I have an existing plans with Rivertown and I was wondering if you could help me cancel automatic billing on my account.	CancelAutomaticBilling
Miss Emily, you can easily upgrade your previous policy to a new money.	ChangePlan
yeah I subscribed to a policy with Rivertown and I think you could be of great assistance in helping me to reset my password?	ResetPassword
Okay, right so I've got an automobile policy with you now and I have decided to shop my home insurance.	GetQuote
Hi, I want to cancel my insurance plan.	CancelPlan
Yea Kate....since I have you online. I would allow you help me recover the password from your system.	ResetPassword
Hello, I want to reset my online account password.	ResetPassword
Hi, I want to cancel my insurance plan.	CancelPlan
Hi, I want to cancel my insurance plan.	CancelPlan
Okay, right so I've got an automobile policy with you now and I have decided to shop a pet basic insurance to it.	GetQuote
So do you think you could email me that quote if I give you my email address?	GetQuote
Yes I'm trying to reset my online password, I created a I forgot my password and I'm trying to pay my bill online.	ResetPassword
Hi, Darcey. This is Mindy with American Life Insurance. I'm responding to your message requesting a change of address.	ChangeAddress
Oh, you may as well do it all.	UpdatePaymentPreference
Yea....since I have you online. I would allow you help me recover the password from your system.	ResetPassword
Okay, right so I've got an automobile policy with you now and I have decided to shop my home insurance.	GetQuote
Okay, I will like to have one of the plans for my new home.	EnrollInPlan
With the informations I have here I will opt-in for basic automobile, home preffered and petcare basic.	EnrollInPlan
Yea....I wish to upgrade my existing plan so I was wondering if You would be able to do that for me.	ChangePlan
#wow...Which one is that?.....I need to pick the better one.	ChangePlan
-huh I would like to upgrade to the basic preferred policy plan.	ChangePlan
Yea...since I have you online. I would allow you help me recover the password from your system.	ResetPassword
yes I would like to report a double billing on my account.	ReportBillingIssue
I would like you to reset the password from here.	ResetPassword
yes I have an existing policy with Rivertown and I was wondering if you could help me get my proof of insurance.	RequestProofOfInsurance
yes I subscribed to a policy with Rivertown and I think you could be of help to me out to add up to my current policy.	EnrollInPlan
So do you think you could email me that quote if I give you my email address?	GetQuote
I want to cancel my insurance plan.	CancelPlan
Yea...since I have you online. I would allow you help me recover the password from your system.	ResetPassword
Hi, I want to cancel my insurance plan.	CancelPlan
yes I subscribed to a policy with Rivertown and I think you could be of help to me to upgrade my current policy.	ChangePlan
So do you think you could email me that quote if I give you my email address?	GetQuote
Hello, I want to reset my online account password.	ResetPassword
yes I have an existing plans with Rivertown and I was wondering if you could help me cancel automatic billing on my account.	CancelAutomaticBilling
yes I have an existing policy with Rivertown and I was wondering if you could help me to add up to my existing policy.	EnrollInPlan
I subscribed to a policy with Rivertown and I think you are in a position to help me reset my password?	ResetPassword
yes I have an already running policy Rivertown and i want to change my current plan and I was wondering if you can help me to solve my last name spelling issue?	ChangePlan
So do you think you could email me that quote if I give you my email address?	GetQuote
#Uh, yes. I want to add my son to my auto insurance plan.	AddDependent
Okay, right so I've got an automobile policy with you now and I have decided to shop my home insurance.	EnrollInPlan
So do you think you could email me that quote if I give you my email address?	GetQuote
yeah I subscribed to a policy with Rivertown and I think you could be of great assistance in helping me to reset my password?	ResetPassword
yeah, I will like to reset my password?	ResetPassword
yeah, I had a few questions about a homeowner's policy. You offer that right?	GetQuote
So do you think you could email me that quote if I give you my email address?	GetQuote
yes I have an existing policy with Rivertown and I was wondering if you could help me to create an account.	CreateAccount
#mhm I want to shop a complete auto policy Ma.	GetQuote
yes I have an existing policy with Rivertown and I was wondering if you could help me to create an account.	CreateAccount
#mhm I want to shop a complete auto policy sir.	GetQuote
Yes i have an existing policy with Rivertown and I was wondering if you could help me get my proof of insurance.	RequestProofOfInsurance
So do you think you could email me that quote if I give you my email address?	GetQuote
I wanted to set up an account, but I couldn't figure out how to do that on your website.	CreateAccount
yes I have an existing policy with Rivertown and I was wondering if you could help me with an upgrade from my current home preferred?	ChangePlan
Okay, right so I've got an home preferred policy with you now and I have decided to shop the home complete insurance.	GetQuote
yes I have an existing policy with Rivertown and I think you could help me delete the account.	CancelPlan
#oh yes I have an existing policy with Rivertown and I was wondering if you could help me to add up to my existing policy.	ChangePlan
yes I would like to report a double billing on my account.	ReportBillingIssue
I would like you to reset the password from here.	ResetPassword
Yea...since I have you online. I would allow you help me recover the password from your system.	ResetPassword
yes I have an existing policy with Rivertown insurance and I was wondering if you could help me on how I can add to it for better productivity.	ChangePlan
Okay, right so I've got an automobile policy and I want to add up a life insurance.	EnrollInPlan
So do you think you could email me that quote if I give you my email address?	GetQuote
Hi, good morning. I want to cancel my insurance plan.	CancelPlan
I want to cancel my insurance plan.	CancelPlan
I would like to cancel my insurance plan.	CancelPlan
Hi, I was wanting to change my billing from yearly to monthly, can I do that?	UpdateBillingFrequency
This is Steve Blaney. I'm calling to cancel my auto insurance plan.	CancelPlan
Hi, I'm not sure who I should speak to, I just called the number on your website. I need to put in a claim, that windstorm last night brought down a big tree, right on top of our house. It hit the car too, and the garage. I'm not sure where to start.	FileClaim
Hi, good morning. I need to change my address with you guys. I just moved.	ChangeAddress
Hi, good morning. I need to speak to someone about changing my security questions. Those things make me crazy. I'm locked out of the online portal because I can't remember one of them.	ChangeSecurityQuestion
Great, how much is it?	GetQuote
Yeah, that makes sense. Okay, I think I'd be okay with the Basic package. I don't have much stuff, the hundred thousand will cover it easily.	EnrollInPlan
Hi Jane, I'd like to cancel my policy.	CancelPlan
Tim. Tim Cranet, c. r. a. n. e. t. Policy number one oh one seven one six three three sev- seven nine zero. Not sure ho- I I lost #eh I can't access my account.	ResetPassword
Yeah, hey Carrie, I need to add my son to my life insurance policy. Do you do that?	AddDependent
#Um I'm just getting in touch because I actually want to cancel my automobile insurance plan. I googled how to cancel the plan and it said to call this number, is that correct?	CancelPlan
That's totally fine. So if for now you're interested in the Home Preferred plan, what we can do today is create an account for you so that when you do feel ready to enroll in a plan, you can do so on our website or give us a ring again if you prefer and we'll already have you on file. I can also send some information pamphlets that include all the clauses of each policy to your email address or out in the mail if you prefer. How does that sound?	CreateAccount
Well you see, I got pulled over a couple days ago and the officer ask me for proof of insurance.	RequestProofOfInsurance
My father recently passed, and I wanna look into his policy and what it covers.	FileClaim
Well, I need to make sure that his automatic payments for his policy are cancelled.	CancelAutomaticBilling
Hello. I want to report an accident.	ReportAutomobileAccident
I'm Katherine Lebeau. I need to file a claim.	FileClaim
Well, I wanted to get a condo quote, but this is customer services, isn't it?	GetQuote
Hi. I need to file a health insurance claim.	FileClaim
Good morning, Sharon. I looking to get a, quote for Renter's insurance.	GetQuote
Yes. To set this up. I wanna be protected before I replace anything.	EnrollInPlan
I'd like to remove a dependent from my life insurance policies.	RemoveDependent
I want to take someone off my life insurance.	RemoveDependent
Hi. I need to report a claim on my property insurance.	FileClaim
Yeah? I'm looking for quotes for my new car.	GetQuote
Yes. So let's sign me up for the Complete Auto Plan.	EnrollInPlan
Wait! I forgot! I wanna change the mailing address on my account!	ChangeAddress
I have a bit of an unusual question. I I'm w-wondering whether I can insure my rabbit?	EnrollInPlan
Yeah I gotta get some information to show proof of my policy to my work, so I guess I need to find out my account number.	RequestProofOfInsurance
I'm calling to get a life insurance quote.	GetQuote
Hello. I got something in the mail from you. A bill I guess. I need to take care of it.	PayBill
I'm hoping to get proof of my car insurance.	RequestProofOfInsurance
Yeah, I'm calling about a billing error.	ReportBillingIssue
#Uh yeah, sure. Let's do that.	CancelAutomaticBilling
Hi, James. I need to change my payment preference and change my security questions.	UpdatePaymentPreference
Hi there, I'm looking to save some money, so I need to change my auto insurance plan.	ChangePlan
Yeah well no if I could, I'd like to go ahead and sign up and transfer my insurance over to you, and then I'll need to send a cancellation to my old current company.	EnrollInPlan
Hi! I've got an auto policy with you and I'd, I'd like to add my daughter.	AddDependent
I would like to get a life quote.	GetQuote
Hi, Mar- Marisol. My name's Jacob Jefferson and I- I was ju- just in an accident.	ReportAutomobileAccident
Yeah, yeah, thanks! And I wanted to know if I, like, for example, got the basic, could I maybe add on just the wellness checks? Are there, like, individual pieces, uh, like services that I could add?	ChangePlan
So, like, the basic for one and the other, the #preferred for the other?	ChangePlan
Actually, I'm also calling because our homeowner's policy with Lakeview is expiring and we wanted to transfer it establish a new policy with you.	EnrollInPlan
OK, and what would the annual rate be, if I decided to pay it all at once?	GetQuote
Hi, Michelle. This is Marisa Baker calling. I've got a family policy with you and my daughter ju- just had an accident. I, my policy number is two three eight four seven nine, then the letter V as in, violet, P as in pink, then six two two.	ReportAutomobileAccident
OK. And what is the, the amount, sorry, I don't remember what it's called, but, like, the amount that I have to pay first?	GetQuote
Yeah! And I wanted to sign up for a- a policy. #Uh, collision and, the other one.	EnrollInPlan
Yeah, yeah! So I haven't looked back at my stuff, my documents, but could you send me some information about your- like, the different types of policies?	GetQuote
Hi. My name's Maria Jacobs. I'm on Walton Street. I think, uh, I might need to report a claim.	FileClaim
My name is John and I was wanting to create an account for my new renter policy.	CreateAccount
Hi I need to change my billing address on my policy.	ChangeAddress
I need my policy number and proof of insurance!	GetPolicyNumber
Hello Timmy this is Betty, widow of Omar. I am calling today to get my life insured. I have never done this. Omar went to see Jesus and did not come back. He kept him.	EnrollInPlan
Why yes, this is Bud Zimmerman. I got me a new wife.	AddDependent
I had someone contact her on LinkedIn, and she talked up a storm there. Absolutely refused to talk about work. That was my plan. Instead she goes off and talks about life. I liked it. Had to marry her. Marian knows too much about me. It has been love sickness with me ever since. Cannot get enough of her. I need to get her on the insurances and want a life insurance policy for her alone.	AddDependent
#Uh Timothy I had an accident. It's not good morning.	FileClaim
Marian Wright here, Timothy. I was trying to pay my insurance online, and it did not confirm the submit.	CheckPaymentStatus
Timothy this is Charlsie Wiley. #Um my husband God rest his soul his perfect soil. Died in an accident of his making. I need to discuss the financial matter of life insurance.	FileClaim
#Um James decided to find a room rather than the dorm. #Uh how do we insure that, Timothy?	GetQuote
Hi Timothy! This is Geraldine from church. I doing some considerations. I need your help in deciding some things to add to my house.	GetQuote
Hello Craig. This is Jim Read. Need to look at policies and make some changes. Changing the plan, I am.	ChangePlan
Let's take a look at my hook 'em horns option homeowner insurance.	ChangePlan
Life insurance. Add a policy the cheapest one you have. Have young son who is an adult coming back home. Out of drug rehab again.	EnrollInPlan
I need to reset my password. I forgot it. Can I do it online?	ResetPassword
I got a new vintage car, Craig. Need one of those special auto quotes.	GetQuote
That's right. John, my husband, chose a military career but he is retiring now. Getting ready to buy our first house that is not military issue.	EnrollInPlan
I have had an incident in my garage workshop.	FileClaim
I need to file a claim, Craig. Storm did some roof damage, knocked a large tree down.	FileClaim
Craig, I'm Brent Brentzel. I want to increase the amount on my life insurance.	ChangePlan
Oh no. No I need life insurance on Brad in prison. Got a felony and accessory to assault at a playground on the assault. He has a smart mouth, and those boys there will assault him.	GetQuote
We do not insure prisoners, Doris but I do have contact with some non-traditional insurance agents that do. Would you like me to contact them for you?	FindAgent
Thats no problem I would be happy to create one for you. Just need to ask you a few questions.	CreateAccount
And how much is like basic life insurance?	GetQuote
Oh awesome, that is cheaper than what we are playing now. Now what about renters?	GetQuote
And how much is that a year?	GetQuote
Are you calling to file a claim and are you the beneficiary?	FileClaim
Well, I'm calling to possibly enroll in pet coverage.	EnrollInPlan
Good morning Frank, I'm calling because I want an life insurance policy.	EnrollInPlan
That's the thing. I was trying to log on and change my phone number and address.	ChangeAddress
Well Josh its not so good. For some reason you took out my payment four days early and for a higher amount and now my bank is overdrawn.	ReportBillingIssue
You can cancel the automatic pay thing is what you can do.	CancelAutomaticBilling
I decided I want to cancel the automatic payments. I just got almost a hundred dollars in overdraft fees.	CancelAutomaticBilling
Hi, my name is Helen Marie and I'm calling because I can't get into my online accountm.	ResetPassword
Hi, I will love to change my address.	ChangeAddress
I'd like to create account with your company.	CreateAccount
Hello. I would love to change my insurance plan.	ChangePlan
So how do I update my payment preference.	UpdatePaymentPreference
#Ummm, I'll like to create an account. I tried doing it on your website but I couldn't, that's why I'm calling.	CreateAccount
Good morning I will like to cancel an operation.	CancelAutomaticBilling
Good morning. I will like to change my security question.	ChangeSecurityQuestion
Okay. I will like to change a plan.	ChangePlan
Hi, I'd like to enroll in an insurance plan.	EnrollInPlan
Hi, I'd like to file property claim of my account. I tried to file it on your website but couldn't. I guess I have to make a phone call to file it.	FileClaim
Hi Susan, I want to cancel my plan now!	CancelPlan
Hey, I'd like to create an account with your insurance company.	CreateAccount
Yeah, Hello I currently have an imminent issue with the police force. Someone bashed my car and I made it clear my insurance cover will not be able to suffice for the damage done, I will like to get a prove of insurance with your company.	RequestProofOfInsurance
I wanted to ask if I could change my password on the website or if I have to make a call before changing it.	ResetPassword
I would like to add a dependent in my plan. Actually I thought I could do it on the website but I couldn't. I guess I have to make a call to make it happen.	AddDependent
Hi I would like to reset my password. I tried to reset the password on your website but couldn't.	ResetPassword
Hi, I will love to create an insurance account with Rivertown insurance company.	CreateAccount
Hi I would like to cancel my insurance plan.	CancelPlan
i just got a new car and I'm looking at having the best insurance coverage on my new whip.	EnrollInPlan
I was sent my statement of account few days ago and I got notice of a few transactions which were deductions from your insurance firm. For the month of September which was last month I got multiple deductions for my September bill. It was deducted twice.	ReportBillingIssue
Yeah, I will like to rectify my billing and yes I will want to update my billing preference too.	UpdatePaymentPreference
That settles the billing issue. You said you wanted to change your payment preference too, correct?	UpdateBillingFrequency
Hi, I'd like to report a billing issue. I checked my credit card transaction history and I was billed twice.	ReportBillingIssue
Well I had pet insurance and let it lapse and now I want to enroll in the plan again.	EnrollInPlan
Hi, I'd like to change to change security my account. I tried to change it on your website but couldn't.	ChangeSecurityQuestion
My friend told me you have an insurance package for pets.	GetQuote
Hi, I'd like to cancel the automatic billing of my account. I tried to cancel it on your website but couldn't. I guess I have to make a phone call to cancel it.	CancelAutomaticBilling
I got an email around last week that automatic billings will now include charges as from next month. I don't quite understand that. Please can you explain to me?	ReportBillingIssue
I will like to create an account with your company.	CreateAccount
I relocate from my previous residence and will like to change my address to a new one.	ChangeAddress
I will like to get the policy number of the planed I enrolled in. I tried doing that on your website but I couldn't.	GetPolicyNumber
I'm calling as regards my enrolment plan for Automobile insurance.	EnrollInPlan
Hi, I'd like to Pay Bill into my account. I tried to do it on your website but couldn't. I guess I have to make a phone call to do it.	PayBill
Hi, I'd like to remove one of dependant in my account. I tried to do so on your website but couldn't. I guess I have to make a phone call for you to help.	RemoveDependent
Hi I would like to cancel automatic billing on my account.	CancelAutomaticBilling
Yes please. I would love to add a dependent to my insurance account.	AddDependent
Amber my name is George and I am moving and need to change my address on my account somehow.	ChangeAddress
Yeah, I was just thinking, can you send the policy quote to my wife's email address?	GetQuote
Hi, I'd like to make bill payment of my account. I tried to do it on your website but couldn't. I guess I have to make a phone call to do it.	PayBill
Hi, I'd like to change my address to a new one. I tried to do that on your website but I couldn't. I guess I have to make a call to change it.	ChangeAddress
Hi, I would like to create an account.	CreateAccount
Hi, I'd like to enroll in an insurance plan.	EnrollInPlan
Fine, I want to get auto quote.	GetQuote
Hey I would like to my home address.	ChangeAddress
Okay, so yeah, I'd like to change the address on my account.	ChangeAddress
I've been trying to log in with my details on the mobile app but my password is not going through. What can I do?	ResetPassword
Can I change my home address and also add a dependent?	ChangeAddress
Hi. I just want to check the status of my last payment. I tried checking it on the website but just couldn't figure it out.	CheckPaymentStatus
Um, Hi, I would like to get a quote on some life insurance.	GetQuote
Hi, I need to reset the password to my account. I tried changing it on your website but I couldn't.	ResetPassword
Hi, I'd like to file health claim in my account. I tried to file health claim it on your website but couldn't. I guess I have to make a phone call to file health claim.	FileClaim
Good morning, I would love to change my address.	ChangeAddress
Hi, I would like to get the policy number of my current plan. Actually, I thought I could get it on the website but I kept on receiving messages I couldn't understand on my mail. I guess I have to make a call to get it.	GetPolicyNumber
Hi, I'd like to add dependent of my account.	AddDependent
I don't seem to remember my password.	ResetPassword
Alright. Can I also change my insurance plan?	ChangePlan
that's where the problem lies. I can't seem to remember my security question.	ChangeSecurityQuestion
I would love to cancel one of my insurance plans with your company.	CancelPlan
#em, I would love to go for the Petcare preferred plan due to the number of my pets.	EnrollInPlan
Hi, I'd like to change plan of my account. I tried to change it on your website but couldn't. I guess I have to make a phone call to change it.	ChangePlan
Hi it's a whole of stress looking for a nearby insurance agent, can you help me out?	FindAgent
Hey yeah, I have to call and report an accident.	ReportAutomobileAccident
Hi, I'd like to change my address to a new one. I tried to do that on your website but I couldn't. I guess I have to make a call to change it.	ChangeAddress
Hi, I'd like to cancel the automatic billing of my account. I tried to cancel it on your website but couldn't. I guess I have to make a phone call to cancel it.	CancelAutomaticBilling
I will like to change my password.	ResetPassword
Hi, I would like to cancel my insurance plan. I tried doing it on the website but I couldn't so I guessed I have to make a call to cancel it.	CancelPlan
yeah so I would like to change my address on my account.	ChangeAddress
Yes. I want to enroll in plan. I tried doing that on the website but unfortunately I can't.	EnrollInPlan
I will like to cancel a plan.	CancelPlan
[Laughter]. You sound so confident. Well, I need to update my payment preference.	UpdatePaymentPreference
I wanted to ask if I could change my password on the website or if I have to make a call before changing it.	ResetPassword
Hi, I'd like to find agent of your insurance company closer to me.	FindAgent
I got an email around last week that automatic billings will now include charges as from next month. I don't quite understand that. Please can you explain to me?	ReportBillingIssue
Good morning, I would like to get a quote on pet insurance.	GetQuote
Okay that sounds good I would like to get him enrolled in that program.	EnrollInPlan
I recently moved to a new city and I need to update my address.	ChangeAddress
Exactly and I also want to add a dependent to my insurance account profile.	AddDependent
Hi, I would like to enroll in an insurance plan. A friend of mine who is also your customer told me I could do it on your website but I had issues with that. I guess I have to make a call to enroll.	EnrollInPlan
I'll help you with creating an account. You don't have to worry about that.	CreateAccount
Perfect. Now that your account has been successfully created, let's continue with enrolling you in the plan of your choice.	EnrollInPlan
Fine, I want to get pet quote.	GetQuote
Hello. How are you doing? I would love to change my insurance plan.	ChangePlan
I checked my credit card transaction history, and it was billed twice last week.	ReportBillingIssue
Hi. I just want to check the status of my last payment. I tried checking it on the website but just couldn't figure it out.	CheckPaymentStatus
I would love to cancel six of my insurance plans with your company.	CancelPlan
What are the questions?	ChangeSecurityQuestion
I would love to register for life insurance and I would love to know the types of, life insurance you have.	EnrollInPlan
Hi, I'd like to cancel the automatic billing of my account.	CancelAutomaticBilling
Hi, I'd like to enroll a plan on my account. I tried to enroll after creating an account it on your website but couldn't. I guess I have to make a phone call to enroll.	EnrollInPlan
I would like to know if you offer any kind of Pet insurance. I love pets so much and I think it's only fitting that I insure them.	GetQuote
I need to reset my password. I don't know I locked myself out again and this is a pain calling in, there use to be a button I could click and reset my password.	ResetPassword
Yes thank you, #em I want to reset my account login password.	ResetPassword
I needed to request a proof of insurance document.	RequestProofOfInsurance
Hi there my name is Michael Stockton, and I have an account with you guys, and I was just trying to check how much was left on my bill, but it seems like your system is down.	CheckAccountBalance
Okay, I can definitely help you with that. Would you like me to connect you with an agent in your area?	FindAgent
Yes, I wanted to cancel my automatic payments.	CancelAutomaticBilling
Yes I wanted to cancel that and just pay off the remaining balance now.	PayBill
Hi there I need to reset the password to my account.	ResetPassword
Hi I was calling to get a quote on a car insurance plan.	GetQuote
I need to I need to cancel my health insurance.	CancelPlan
Oh hi, I need to put in a change of address please.	ChangeAddress
Hi there, I need to reset the password for the account to my auto insurance.	ResetPassword
Yeah I was just trying to change my billing address, but I guess I just couldn't remember my password.	ChangeAddress
I was sent my statement of account few days ago and I got notice of a few transactions which were deductions from your insurance firm. For the month of September which was last month I got multiple deductions for my September bill. It was deducted twice.	ReportBillingIssue
Yeah, I will like to rectify my billing and yes I will want to update my billing preference too.	UpdateBillingFrequency
Good morning. I will like to change my security question.	ChangeSecurityQuestion
Yeah, Hello I currently have an imminent issue with the police force. Someone bashed my car and I made it clear my insurance cover will not be able to suffice for the damage done, I will like to get a prove of insurance with your company.	RequestProofOfInsurance
Hey, I'd like to create an account with your insurance company.	CreateAccount
yeah so I would like to change my address on my account.	ChangeAddress
Okay, so yeah, I'd like to change the address on my account.	ChangeAddress
I'm calling as regards my enrolment plan for Automobile insurance.	EnrollInPlan
The services I have being receiving from your company has being encouraging and my intent is to increase or enroll for more plans with you.	EnrollInPlan
Ok then, but first can I get my current policy number.	GetPolicyNumber
Mhm, about that I will like to get a quote for the Life insurance first.	GetQuote
I'd like to create account with your company.	CreateAccount
Hi, I'd like to change my address to a new one. I tried to do that on your website but I couldn't. I guess I have to make a call to change it.	ChangeAddress
I would like to cancel the automatic billing on my account.	CancelAutomaticBilling
Fine, I want to get pet quote.	GetQuote
I want to enroll in one of your insurance plan.	EnrollInPlan
Hi I would like to reset my password. I tried to reset the password on your website but couldn't.	ResetPassword
Hi, I'd like to enroll in an insurance plan.	EnrollInPlan
Yes, how do I make payment?	PayBill
Hi. I just want to check the status of my last payment. I tried checking it on the website but just couldn't figure it out.	CheckPaymentStatus
I will like to cancel a plan.	CancelPlan
i just got a new car and I'm looking at having the best insurance coverage on my new whip.	EnrollInPlan
I would love to register for life insurance and I would love to know the types of, life insurance you have.	EnrollInPlan
Well mhm I think my bill is due. Can you check first?	PayBill
Then yes I do wanna pay it.	PayBill
Yeah. Hi. I need to get my ex off my auto insurance policy.	RemoveDependent
Why don't you remove yourself, and start a new policy.	EnrollInPlan
I recently moved to a new city and I need to update my address.	ChangeAddress
Exactly and I also want to add a dependent to my insurance account profile.	AddDependent
Hi, I'd like to change to change security my account. I tried to change it on your website but couldn't.	ChangeSecurityQuestion
Hi, I will love to change my address.	ChangeAddress
Hi, I'd like to change plan of my account. I tried to change it on your website but couldn't. I guess I have to make a phone call to change it.	ChangePlan
well, I would also like to know if you offer any kind of Pet insurance. I love pets so much and I think it's only fitting that I insure them.	GetQuote
Hi, I'd like to report a billing issue. I checked my credit card transaction history and I was billed twice.	ReportBillingIssue
I will like to change my password.	ResetPassword
Hi, I'd like to make bill payment of my account. I tried to do it on your website but couldn't. I guess I have to make a phone call to do it.	PayBill
I will like to enrol for the life insurance policy.	EnrollInPlan
Ok then, but first can I get my current policy number.	GetPolicyNumber
Mhm, about that I will like to get a quote for the Life insurance first.	GetQuote
Hi I would like to cancel automatic billing on my account.	CancelAutomaticBilling
Yes please. I would love to add a dependent to my insurance account.	AddDependent
Hi, I would like to get the policy number of my current plan. Actually, I thought I could get it on the website but I kept on receiving messages I couldn't understand on my mail. I guess I have to make a call to get it.	GetPolicyNumber
Hi, my dad recently kicked me off his car insurance policy and said I needed to start paying for my own. So th- that's what I need to do now I guess.	EnrollInPlan
uh-huh. How do I go about it?	GetQuote
#em, I would love to go for the Petcare preferred plan due to the number of my pets.	EnrollInPlan
oh! Okay. Kindly deduct the insurance fee for my pets from my credit card.	UpdatePaymentPreference
Hi, I'd like to cancel the automatic billing of my account. I tried to cancel it on your website but couldn't. I guess I have to make a phone call to cancel it.	CancelAutomaticBilling
I checked my credit card transaction history, and it was billed twice last week.	ReportBillingIssue
Hello. How are you doing? I would love to change my insurance plan.	ChangePlan
I would love to upgrade my home owner insurance plan.	ChangePlan
Hi, I'd like to Pay Bill into my account. I tried to do it on your website but couldn't. I guess I have to make a phone call to do it.	PayBill
I wanted to ask if I could change my password on the website or if I have to make a call before changing it.	ResetPassword
Hi, I'd like to add dependent of my account.	AddDependent
Hey I would like to my home address.	ChangeAddress
mister Brian Hogwart who just recently insured his pets referred me to your insurance company.	GetQuote
Alright. So how do I go about it?	EnrollInPlan
Hi, I'd like to cancel the automatic billing of my account. I tried to cancel it on your website but couldn't. I guess I have to make a phone call to cancel it.	CancelAutomaticBilling
Well I'm calling today to change my address on my account.	ChangeAddress
I'd love to get a quote.	GetQuote
Oh yeah, if you can find me an agent that would be great.	FindAgent
Hi, I'd like to remove one of dependant in my account. I tried to do so on your website but couldn't. I guess I have to make a phone call for you to help.	RemoveDependent
I will like to create an account with your company.	CreateAccount
Hi, I would like to enroll in an insurance plan. A friend of mine who is also your customer told me I could do it on your website but I had issues with that. I guess I have to make a call to enroll.	EnrollInPlan
Good morning, I would love to change my address.	ChangeAddress
I will like to get the policy number of the planed I enrolled in. I tried doing that on your website but I couldn't.	GetPolicyNumber
Hi, I would like to create an account.	CreateAccount
I would love to cancel one of my insurance plans with your company.	CancelPlan
I'll help you reset your security question ma'am.	ChangeSecurityQuestion
[Laughter]. You sound so confident. Well, I need to update my payment preference.	UpdatePaymentPreference
Hi, I need to reset the password to my account. I tried changing it on your website but I couldn't.	ResetPassword
Hi, I'd like to file health claim in my account. I tried to file health claim it on your website but couldn't. I guess I have to make a phone call to file health claim.	FileClaim
Right, my deductible is only $five zero zero, and I paid almost $two five zero zero over three months!	ReportBillingIssue
Waive the legal fee. Give the man the coverage. If I come for him he'll need it.	ChangePlan
Alright. So how do I go about it?	EnrollInPlan
Hi, I'd like to enroll a plan on my account. I tried to enroll after creating an account it on your website but couldn't. I guess I have to make a phone call to enroll.	EnrollInPlan
I've been trying to log in with my details on the mobile app but my password is not going through. What can I do?	ResetPassword
Can I change my home address and also add a dependent?	ChangeAddress
Fine, I want to get auto quote.	GetQuote
Hi, I would like to cancel my insurance plan. I tried doing it on the website but I couldn't so I guessed I have to make a call to cancel it.	CancelPlan
Well, I don't know if your company offers any kind of renters insurance.	GetQuote
Hi. I just want to check the status of my last payment. I tried checking it on the website but just couldn't figure it out.	CheckPaymentStatus
I wanted to ask if I could change my password on the website or if I have to make a call before changing it.	ResetPassword
Yes thank you, #em I want to reset my account login password.	ResetPassword
Hello. I would love to change my insurance plan.	ChangePlan
So how do I update my payment preference.	UpdatePaymentPreference
I would like to cancel the automatic billing on my account.	CancelAutomaticBilling
#Um yeah hi, I've got an insurance plan for my car with you guys, and I'm just wanting to let you know that I'm actually moving next week and thought I should let you know about updating my address.	ChangeAddress
sounds good. I think I'd love the complete automobile plan.	EnrollInPlan
I would love to cancel one of my insurance plans with your company.	CancelPlan
Yes. I want to enroll in plan. I tried doing that on the website but unfortunately I can't.	EnrollInPlan
Hi, I'd like to change my address to a new one. I tried to do that on your website but I couldn't. I guess I have to make a call to change it.	ChangeAddress
i will like to file a property claim.	FileClaim
I would like to add a dependent in my plan. Actually I thought I could do it on the website but I couldn't. I guess I have to make a call to make it happen.	AddDependent
Yea, I'd like to enroll a plan in my account. I tried to enroll it on your website but couldn't. I guess I have to make a phone call to enroll it.	EnrollInPlan
I don't seem to remember my password.	ResetPassword
Alright. Can I also change my insurance plan?	ChangePlan
Hi, I'd like to find agent of your insurance company closer to me.	FindAgent
well, I would also like to know if you offer any kind of Pet insurance. I love pets so much and I think it's only fitting that I insure them.	GetQuote
#Ummm, I'll like to create an account. I tried doing it on your website but I couldn't, that's why I'm calling.	CreateAccount
Yes I would like to add a dependent to my policy. Last year I added my son but I've had another baby since then so I was hoping to add him as well.	AddDependent
Hi, I will love to create an insurance account with Rivertown insurance company.	CreateAccount
Automatic Billing.	CancelAutomaticBilling
Hi, I'd like to file property claim of my account. I tried to file it on your website but couldn't. I guess I have to make a phone call to file it.	FileClaim
Yes. I got an email around last week that automatic billings will now include charges as from next month. I don't quite understand that. Please can you explain to me?	ReportBillingIssue
Okay. I will like to change a plan.	ChangePlan
Hi. I want to cancel automatic billing on my account.	CancelAutomaticBilling
Yes please. I would love to add a dependent to my insurance account.	AddDependent
I relocate from my previous residence and will like to change my address to a new one.	ChangeAddress
Hi it's a whole of stress looking for a nearby insurance agent, can you help me out?	FindAgent
Hi, I'd like to cancel the automatic billing of my account.	CancelAutomaticBilling
#Uh hi, Mark. I would like to get my car insured.	EnrollInPlan
#Um yes. Hi, this is Sarah. I would like to I need help creating an account.	CreateAccount
Yeah you guys keep taking money out of my account and I didn't tell you you could do that. It's been this way for months.	ReportBillingIssue
Okay. So you want to cancel it permanently. Is that correct?	CancelAutomaticBilling
Hi, I would like to cancel my automatic billing please.	CancelAutomaticBilling
Yes, I want a bill in the mail each month and all credit card information in my file deleted.	UpdateBillingFrequency
I live in an apartment and my lease is up. I need proof of my renter's insurance to to sign my new lease.	RequestProofOfInsurance
I would like to update my payment preferences please.	UpdatePaymentPreference
Yes, that is correct. I would like to change from my checking account to my credit card for my autopay.	UpdatePaymentPreference
I would like to create an account please.	CreateAccount
Hello, I would like to add a dependent to my health insurance please.	AddDependent
Hi, I would like to remove a dependent from my health insurance plan, please.	RemoveDependent
Hi, Edith. I would like to cancel my health insurance, please.	CancelPlan
I am also getting dental and vision through my new employer. I would like to cancel these plans as well.	CancelPlan
Hello, I would like to check the status of my payment please.	CheckPaymentStatus
I would like to update the address on my account please.	ChangeAddress
Yes I need to change the way I pay you guys.	UpdatePaymentPreference
Yes I just need to change the card I'm paying with.	UpdatePaymentPreference
I would like to change the password on my account that I have for pet insurance.	ResetPassword
Thank you. I would like to change the security question on my account please.	ChangeSecurityQuestion
Yes, that is why I am calling to change my security question. I guess I will need to change this password as well.	ResetPassword
Hello, Sarah. I would like to cancel my auto insurance.	CancelPlan
Hello, I would like to find an agent please.	FindAgent
Hello, Mary. I need to pay my bill.	PayBill
I would like to change the billing frequency on my account please. That once a year payment for auto insurance is a big hit.	UpdateBillingFrequency
I would like to sign up for auto insurance.	EnrollInPlan
Okay, Crystal, my wife usually handles all of the bills, but she's been sick so I was calling to see if the bill for last month had been paid she's been sick for a few weeks now and I'm not sure if she paid the insurance can you help me.	CheckPaymentStatus
Okay, so how do I do that? Nancy always did it I'm not sure how to pay the bill. Can you help me?	PayBill
Well, I attempted to pay it, but I'm not sure if it went through? It just kept spinning after I clicked submit, and I never got one of those confirmation emails. So is there a way you can check that for me?	ReportBillingIssue
Yeah hi hello, I've been waiting for twenty minutes and all I wanted was my stupid policy number.	GetPolicyNumber
Hi Amy. This is Mel and I am calling to sign up for pet insurance.	EnrollInPlan
Ok. How much does something like this cost?	GetQuote
I just want to know what my account balance is.	CheckAccountBalance
Can I go ahead and pay it?	PayBill
So I need to report the accident to you, correct?	ReportAutomobileAccident
Hi Joe, I need to pay my bill.	PayBill
Hello Joan, I'm calling today for life insurance.	GetQuote
I just moved, so I need to change my address.	ChangeAddress
Hi there. I need my policy number.	GetPolicyNumber
Some issue with my security question. I couldn't login.	ChangeSecurityQuestion
Well, I actually need to cancel my policy.	CancelPlan
I just need to pay a bill.	PayBill
Is there any way to get a quote also?	GetQuote
Okay sorry about that. I wanted to speak with someone who could help me cancel my current plan.	CancelPlan
#Um I am looking to cancel my policy with you.	CancelPlan
Yes alright, okay well, I need to update my payment preference.	UpdatePaymentPreference
I'd like to try to Sorry, hang on. #Um I was trying to change my package, if that's possible?	ChangePlan
Right, yeah I understand completely. Ok I'm seeing that your policy is actually outdated and we don't currently offer an upgrade on it so you'll have to switch policies completly. Is that ok?	ChangePlan
Hi, I need to get insurance.	EnrollInPlan
Okay, I I unlocked your account, now I'll help you reset your password.	ResetPassword
Hi, I we just had a baby and I want to add her to our policy, can I do that or do I have to wait until she's older?	AddDependent
Hello, my name is Kerry Silver. I need some help. You see I can't remember if I made a payment or what my balance is we have been so busy this month and.	CheckAccountBalance
So we can get that paid today and keep you going, okay?	PayBill
Hi, I'd like to report an accident.	ReportAutomobileAccident
Hello Jenny, I'd like to get some insurance for a condo we just bought or we're buying now I was told we had to get insurance but I really don't know what type.	EnrollInPlan
Hi, Charlie, I'm calling because I I'm trying to renew my registration and they say I need paperwork from my insurance company before I can renew.	RequestProofOfInsurance
Hi, yes. I was hoping you could tell me what my balance is.	CheckAccountBalance
Umm. Let's just go ahead and pay the entire amount.	PayBill
yeah I want the automatic payments to stop coming out of my bank! Can you do that for me?	CancelAutomaticBilling
Hi my name is Carlos and I am looking to reset my password.	ResetPassword
Actually yeah. Can you transfer me to billing?	PayBill
Sure! I can help you with that, John. So, you're wanting to drop the full coverage policy for something.	ChangePlan
Oh, oh yeah. I need to to to sw- transfer my to change my address. You see, we just moved.	ChangeAddress
Oh yes, okay. #Uh well you see, my grandson Jeremiah has moved into our house because well yes.	AddDependent
Yes Matt, I'd like to remove my son from my policy.	RemoveDependent
So would you like to sign up for the Premium Gold plan then?	EnrollInPlan
Yes our house flooded in that bad storm yesterday.	FileClaim
Uh hello yeah. I would like to add my new dependents to my policy.	AddDependent
Yes so would you like for me to add the premium package then?	ChangePlan
Hi, my name is Jane Janeson and I'm having a problem with my billing statement.	ReportBillingIssue
Hi I'd like to make a payment on my account.	PayBill
Hi yes I I'm new to my area and I need to find me a new local insurance agent.	FindAgent
Oh yeah . I need to update my address.	ChangeAddress
Can you update my girlfriends file to?	ChangeAddress
Hi Mark yes we just had a baby, so I need to get her added to our health insurance.	AddDependent
#Ah yeah I'm having issues with my billing and need to get the automatic payments turned off.	CancelAutomaticBilling
Yeah actually, I mentioned being overcharged on my bills. I need to get that fixed.	ReportBillingIssue
Yh, i tried to follow the step by step process you sent to my Email address but I'm having issues with the password.	ResetPassword
So i was wondering if the company has a branch over there.	FindAgent
nah, considering how busy I'll be i called to know if an agent of the company would assist me change plan and do some other things.	ChangePlan
I want a change of plan, is it possible?	ChangePlan
I'm calling regarding an accident that happened.	ReportAutomobileAccident
yes I need to make sure my payment has gone through.	CheckPaymentStatus
yeah our son just turned twenty six, so I guess I need to remove him from our insurance policy.	RemoveDependent
yes, hi, I'm in the process of moving and I need to change my address on my account.	ChangeAddress
Oh hi yes I need to get that paper for my car that shows I have insurance.	RequestProofOfInsurance
Hi Jason. My name is Miranda and I am having an issue with automatic billing.	ReportBillingIssue
So I would like to change my automatic billing.	CancelAutomaticBilling
yeah on my online account I need to change that security question and I can't figure out how.	ChangeSecurityQuestion
yes, I need to take care of my bill.	PayBill
yes, I've made my account online and I've been doing my research, so I think I'm ready to enroll.	EnrollInPlan
well, so yeah before I forget, where can I get a copy of my insurance for my car?	RequestProofOfInsurance
Hi Sandy, yeah this Mike Harlow. I need to change my payment option please.	UpdatePaymentPreference
Hi yeah I need to change how I'm billed.	UpdateBillingFrequency
Yes, hi I've forgotten my password and I'm not having any luck resetting my password online.	ResetPassword
Hi yes I need to cancel my car insurance.	CancelPlan
Hi. I'm calling about pet insurance. Am I in the right department?	GetQuote
Yeah I guess I need to remove my son from my plan seeing how he's actually a functional adult now with a job.	RemoveDependent
Yes. I want him off both please.	RemoveDependent
No. actually I've been looking a car but I haven't decided if I am going to get it or not. Can you give me a quote?	GetQuote
Yes, hi Ronnie. I'm looking to like upgrade I guess my current plan?	ChangePlan
One of my doctor's gave me the information to file a claim with you guys. like they lost their billing person or something.	FileClaim
Well, I don't want to waste your time. I called because I need some insurance.	EnrollInPlan
#Uh, hi, I need to, I need to change my address. I recently moved.	ChangeAddress
And could I also change my card payment? I really need to get that changed.	UpdatePaymentPreference
Hi, I wanted to enroll in one of your auto insurance plans.	EnrollInPlan
But I got a letter in the mail from Rivertown saying my payment didn't go through, and I was like, why? I sent the money!	ReportBillingIssue
Well, I've still got the money so, can I pay my balance now?	PayBill
#Uh, yeah. I'll do that. I'd also like to make it my preferred method of pay.	UpdatePaymentPreference
Oh, good! Can you send a receipt for the payment to my email?	RequestProofOfInsurance
#Um, I need to change it so that I'm not billed automatically.	CancelAutomaticBilling
Yes, I'd also like to change the card that is used for the auto payments.	UpdatePaymentPreference
Hi, yes, I'm calling about cancelling a home insurance plan that my husband and I have.	CancelPlan
Yeah, that would be. That would be great, actually.	CreateAccount
Stacey. Hi, Stacey. I'm hoping to enroll in a life insurance plan today, if that's alright.	EnrollInPlan
Thank you. So yeah. I Yeah. If you don't mind a quote, please. Would be great.	GetQuote
Hi I just had my baby and need to add him to my insurance policy.	AddDependent
Ok. Can you send me a copy of my plan?	RequestProofOfInsurance
Hi, yes, I'm calling about cancelling a home insurance plan that my husband and I have.	CancelPlan
Ok. I was scammed and I need to cancel this policy now!!	CancelPlan
I was quoted a basic plan for two hundred dollars a year and my bank account was charged more, a lot more!	ReportBillingIssue
Hello Kelly. My name is Sally Green and I need to add someone to my policy.	AddDependent
Great. We moved so let me give you the new address.	ChangeAddress
Hello, I need to file a claim for property damage.	FileClaim
Hello, I need to file a life insurance claim. My grandmother passed away.	FileClaim
#Um, I made a payment for my plan, but I just received a mail that I owe.	ReportBillingIssue
But in the mean time, can you make a note on my account saying I previously sent a cheque, but it got lost in transit.	ReportBillingIssue
#Um I have a policy with you. Is it possible to update my payment method?	UpdatePaymentPreference
#Um I guess so, can you confirm the outstanding balance on my plan please.	CheckAccountBalance
Well, I noticed that I do not get the invoice for my monthly payment, and I was wondering why that is so.	ReportBillingIssue
Can I update my billing frequency then?	UpdateBillingFrequency
#Um, I just want to pay a bill.	PayBill
I received a mail that I have an outstanding balance, can you confirm my balance first.	CheckAccountBalance
Can you help me with the exact balance on the account.	CheckAccountBalance
Okay so I have no outstanding balance right?	CheckAccountBalance
Hi I need to remove my husband off my car insurance.	RemoveDependent
Hi Holly, I would just like to cancel my insurance plan.	CancelPlan
mmm, well I just moved to another town, and I would just like to update my address.	ChangeAddress
I'm calling to find out if it is possible to include my husband in my insurance?	AddDependent
Oh, hey Jim, I am looking for a new policy yeah, what do I need to do to file it?	EnrollInPlan
Okay, yeah, I think I'd like to change to that please.	ChangePlan
Oh, hey Tyler, I am looking for a new policy yeah, what do I need to do to file it?	ChangePlan
Okay, yeah, I think I'd like to change to that please.	ChangePlan
Of course, and now, shall we go ahead and get you enrolled in a homeowner's policy?	EnrollInPlan
Yeah, unfortunately. I wanted to file an auto claim and figure out I guess what I need to do next.	FileClaim
Sure, so my son is graduating from college, and I'm wanting to take him off my policy.	RemoveDependent
Oh, hey Logan, I am looking for a new policy yeah, what do I need to do to file it?	EnrollInPlan
Okay, yeah, I think I'd like to change to that please.	ChangePlan
Okay, how much?	GetQuote
So I guess I'll go with the preferred policy.	EnrollInPlan
Hi, Mark, this is John with Rivertown Insurance, I received an email from you saying you wanted to cancel your homeowner policy. #Um, is that still the case?	CancelPlan
Okay, yeah, I think I'd like to change to that please.	ChangePlan
Of course, and now, shall we go ahead and get you enrolled in an automotive policy?	EnrollInPlan
Hi Ken I was returning your call it looks like you want to pay a bill?	PayBill
Oh, yeah, I am what do I need to do to enroll? Can you help me with that?	EnrollInPlan
#Um sure, yeah I think that should work.	CreateAccount
Sure, so I'm planning on purchasing a new car, but in order to do that, I need to present proof of insurance to the dealership.	RequestProofOfInsurance
So let me just initiate this Alright, so I need verbal confirmation that you are wanting to cancel your homeowner's policy.	CancelPlan
Oh, hey Liam, I am looking for a new policy yeah, what do I need to do to file it?	EnrollInPlan
Mhm, is there anything a little cheaper than that? I think my wife was wanting me to reduce our coverage.	ChangePlan
I was-I was just wondering. If it was possible. #Um, I'd like to get a homeowner's quote?	GetQuote
Well, I think maybe we should just go ahead and do it. What do you think, Lucy? Oh she's up and gone adventuring.	EnrollInPlan
Hi there I need to change the payment info on my auto pay.	UpdatePaymentPreference
Yes I recently filed for divorce and I need to remove my husband from my health insurance.	RemoveDependent
Yes I'm trying to get a new apartment and they require proof of renter's insurance. Is there anyway I can get that sent to them.	RequestProofOfInsurance
Yeah. You guys are overbilling my account and I'm sick of it. You need to fix it.	ReportBillingIssue
Hi, I was calling cuz I needed to pay my bill. I bounced my auto pay, or whatever you call that to autopay.	PayBill
uh huh, right go on.	UpdateBillingFrequency
So mister Swanson, you would like me to cancel your automatic bill payment and then switch your payment options to quarterly is that correct?	CancelAutomaticBilling
Hey there my name is Cindy Peebles and I have been a customer for years and I need to change my address and I've never had to do that before so I don't know how.	ChangeAddress
Hello. I need to remove someone from my plan.	RemoveDependent
Hey yes I just recently moved to a different place and need to change my address and phone number that I have with you guys.	ChangeAddress
Perfect. Can I get a quote for that? I'm already a customer with you guys and have nothing but good experiences.	GetQuote
Hey yes I mailed my bill about a week ago and I haven't seen it get credited to my account and I just want to check on that.	CheckPaymentStatus
Hey I'm trying to organize my hurricane kit and I realized I don't have my policy number for you guys. Can you provide that for me?	GetPolicyNumber
Sure. We can do that.	PayBill
Yes my name is John Brown, policy number one two three four five six seven eight and I need to report an accident.	ReportAutomobileAccident
Yes I need to update some of my security information on here. I think someone got ahold of my info and is trying to pretend to be me.	ChangeSecurityQuestion
Oh that's fine. Hey while I'm at it can we change my password online too?	ResetPassword
Hey yes I have a renewal coming up and I usually pay only once a year but this year I can't make one large payment. I need to see if I can do it monthly.	UpdateBillingFrequency
Hey I got several policies with you guys but I saw online that you offer pet insurance. Can you tell me how much that costs?	GetQuote
I wanna add a dependent to my life and auto policy.	AddDependent
Yeah my name is Ricky Johnson and I'm customer there. I haven't had access to a computer in a while and I need to see when my bill is due and make a payment.	PayBill
Hey I was wondering if I could get a quote for car insurance. My friend uses you guys and had some good things to say. I'm trying to lower my premiums.	GetQuote
Yes. I just recently got married and I've been with you guys for years so I'd thought I'd add my new husband as a dependent.	AddDependent
Great. Can I go ahead and pay that now?	PayBill
Yeah I'm at the DMV and I'm trying to register my car but they need proof of insurance so I guess I need you to send me a copy.	RequestProofOfInsurance
Hello I just recently moved and I need to update some information with you guys.	ChangeAddress
I kept trying but I guess I just can't remember the password.	ResetPassword
Yes I want to see if I can change my payment from monthly to annually. I keep forgetting to pay it every month.	UpdateBillingFrequency
Hi I got a notice in the mail that if I don't pay my bill you guys are going to cancel my policy so I guess I need to pay it.	PayBill
Yes I recently got married and need to add my husband to my health insurance policy.	AddDependent
Hi. I wanna stop my automatic payments.	CancelAutomaticBilling
Great. I think they've been charging me twice in one month.	ReportBillingIssue
Oh! I need to pay my bill and ask a question about auto-pay.	PayBill
Yeah I'm trying to register my car and they need my insurance number and I don't have it.	GetPolicyNumber
How do I get proof of that?	RequestProofOfInsurance
I don't know my password.	ResetPassword
Yes we just adopted a new baby and I need to add her to my health plan.	AddDependent
Yeah I need to check my account balance.	CheckAccountBalance
Okay. Can you tell me the life insurance now?	CheckAccountBalance
Would you like to go ahead and make a payment?	PayBill
Yes, I need to file a claim. We lost my wife this week.	FileClaim
Yes my name is Carol Brown and I've been a customer with you guys for about six years but I'm afraid someone has my information so I need to change my security question.	ChangeSecurityQuestion
Hey I mailed my check a few days ago to pay you guys and I don't see where it has hit my account. Can you tell me if you see it on your end?	CheckPaymentStatus
Yes. I think I've been a victim of identity theft so I need to change my security question for you guys so I can keep my stuff safe.	ChangeSecurityQuestion
Thank you Olivia. We will probably just need to reset your password in order to clear that error message.	ResetPassword
well I got my bill yesterday and why is it higher this time?	ReportBillingIssue
No I didn't change anything. I wanna take my credit card off my account.	UpdatePaymentPreference
Sure I can do that misses Gray. Now once I take your credit card off of your account that will stop the automatic payments.	CancelAutomaticBilling
Can we talk about why my bill is higher please? I well I can't pay this much. It's too high. I don't have that much money.	ReportBillingIssue
Hi, Holly. I'm Melissa Stimson and I want to change the way I pay automatically.	UpdatePaymentPreference
Yeah I need to go ahead and set up my plan to be cancelled. I've found a better company to cover me.	CancelPlan
Hey! My name is Kara Turner and I have a few policies with you guys. I just recently moved and so I want to update you guys with my new address.	ChangeAddress
Yeah I have been shopping for car insurance and had saw an ad for you guys and thought I'd see if you could beat the other rates I've got.	GetQuote
Yeah I need to update my address with you guys and pay my bill.	ChangeAddress
Yes. I need to do something about lowering my premiumiss I recently lost my job and just can't afford the payments anymore. I don't want to change companies. I've been with you guys for years.	ChangePlan
Hey I currently have life and health insurance with you guys and I recently got a quote for auto insurance that I would like to go ahead and enroll in.	EnrollInPlan
Yes I need to check my account balance with you guys. I don't think I've paid my bill this month so I need to make sure.	CheckAccountBalance
Would you like to go ahead and make that payment while we're on the phone?	PayBill
Hello there. I heard you guys do pet insurance and I just thought that was the neatest thing. Do you think I could get a quote on a policy?	GetQuote
Yes my name is Rita Wilson, customer ID one two three four five six seven eight, and I need to add someone to my life insurance plan.	AddDependent
Hey there. I'm shopping around for some condo insurance and was hoping to get a quote from you guys.	GetQuote
Hi, Natalie. I want to cancel my automatic billing.	CancelAutomaticBilling
Yes I need to file a claim for a doctor visit.	FileClaim
This is John Brown, I'm an agent with Rivertown Insurance following up with you on a request to enroll in an auto insurance plan.	EnrollInPlan
Yeah when will I get proof of insurance?	RequestProofOfInsurance
Yes my name is Jack and I got a flyer for you guys saying that you offere homeowner's insurance in my area and I just wanted to see what you could offer me.	GetQuote
No. I think I want to go ahead with it.	EnrollInPlan
Hi yes. My name is Jasmine Glover and I need to get proof of insurance sent to me.	RequestProofOfInsurance
Hi I got a notice in the mail saying I was past due. I must have forgot to send you guys a check this month. I need to go ahead and fix that if you can help me please.	PayBill
Yeah I need to cancel automatic payments. You guys have been overcharging me.	CancelAutomaticBilling
Yes. I was just in an accident.	FileClaim
Yes I'd like to get a quote on renter's insurance. My friends have all said you guys give great prices and service and I just moved into this place that requires it.	GetQuote
Yes I need to check the balance on my policy and possibly pay a bill if the payment is due.	CheckAccountBalance
Okay great. Can I go ahead and pay that?	PayBill
#Uh yeah, I am trying to find an insurance agent.	FindAgent
Hi there I need to see if a payment has been credited to my account.	CheckPaymentStatus
Yes my house was damaged in the last hurricane and I need to file a claim. I've been a customer for years so I hope it doesn't mess up my rates.	FileClaim
Yeah I got a notice in the mail offering a discount for new policies and I was in the market for new life insurance so I was wondering if maybe I could get some information about that.	GetQuote
Yes, I'm in the market for new homeowners insurance and I wanted to see what you guys could offer me. I've read some good reviews about you guys.	EnrollInPlan
How much is it?	GetQuote
That sounds better. What's the cost?	GetQuote
Yeah I can't seem to get logged in online. I've been with you guys for years and this is the first time it's ever given me problemiss It's starting to get on my nerves.	ResetPassword
Good afternoon, Sandra! I got your information from one of our phone reps that stated you were interested in enrolling in one of our auto insurance plans.	EnrollInPlan
I think I'm going to go with the higher one because of rental reimbursement.	EnrollInPlan
Hey I'm working with a local agent and they said I need to call and set up an account so I can finish purchasing my new auto plan.	CreateAccount
Yes I just recently moved and I need to update my address on my policies with you guys.	ChangeAddress
Yes I've heard a lot of good things about you guys from friends and family and I was interested in finding a local agent to talk about signing up for one of your plans.	FindAgent
Well I don't have a pet and I'm not too happy with my life insurance policy right now.	GetQuote
So you would like to have an agent call you about life and auto? Is that correct?	GetQuote
Hi Jared, we got a notification of an accident that you were in recently and we wanted to go ahead and start the claims process.	FileClaim
I need to change my address. I recently moved from my previous residence so I'm gonna need my address updated to my current residence.	ChangeAddress
Great! Can you forward a quote and all the information I'm gonna need to my mail. I'm running late on an appointment.	GetQuote
Yes my name is John and I've been a customer a while with you guys. I was wondering if I get any discounts from changing my bill from monthly to yearly?	UpdateBillingFrequency
Hey I would like to see if you guys have an agent near me. I've been interested in moving my policies to you guys but I need to know if there's someone close to me.	EnrollInPlan
Yes my name is Margaret Johnson. My customer ID is one three two four five six seven eight, and I sent a check in last week and I haven't seen it get credited to my account.	ReportBillingIssue
Yes I need to cancel my plan with you guys. I was able to find a lower price somewhere else.	CancelPlan
Yes my name is Jack Henry and I need to add someone to my health insurance plan.	AddDependent
I need to report a claim.	FileClaim
Yeah, I just need it for my apartment.	GetQuote
Oh, great! No problem! I was already sold on the-on the one fifty thing so I guess we should just go with the bug one.	EnrollInPlan
Hi, I needed to change my address. I'm-I'm moving.	ChangeAddress
Morning, I just needed to request proof uf, what is it called? Proof of policy?	RequestProofOfInsurance
Oh, right! To do things online!	CreateAccount
#Uh, hello? I just wanted to find out how to find an agent close to me.	FindAgent
I recently got a new vehicle and I wanna make enquiries on how to get insured.	GetQuote
Yeah I would love that but also I- I would appreciate if you could walk me through my options before I make my decision. Then go ahead and add my wife to my policy.	AddDependent
sounds amazing! Sign me up right away for the complete auto.	EnrollInPlan
We just received a text saying, we're late? We're late paying our bill?	ReportBillingIssue
I can set up auto-pay?	UpdatePaymentPreference
Well, I need to drop someone who's been on my insurance.	RemoveDependent
Yes, yes-I'm just needing my policy number? Just wondering if this is where I call to get that?	GetPolicyNumber
Oh, you're too sweet, dear. Anyhow, I'm just calling because we finally have a closing date for the new house, and I thought we could get that address changed and the new insurance set up?	ChangeAddress
#Uh, hi. I was calling b-because I need to cancel my policy.	CancelPlan
Hi there. #Uh, I just have an account and needed to check my balance?	CheckAccountBalance
Oh, yeah. That would be great. Would it be late if I made it this way?	PayBill
Okay, yeah. I mean, five dollars might not be much, but it's five dollars, right? .	UpdatePaymentPreference
I'm moving, and need to update my address.	ChangeAddress
My wife was wanting to ask, is it possible to change our billing frequency?	UpdateBillingFrequency
#Uh, hello? I called earlier this week, and I just needed help canceling my mom's policies.	CancelPlan
Yeah, I just moved? I need to-need to update my address?	ChangeAddress
I darn it, hang on, would like to enroll in a plan.	EnrollInPlan
Hello, my name is Janet Baker. I just needed to change my password for the website?	ResetPassword
#Um, hello, I am calling to file a claim?	FileClaim
Oh, I, no-I'm sorry. I wasn't clear. I'm calling about a life insurance claim?	FileClaim
#Uh, can I go ahead and cancel those policies?	CancelPlan
I'm actually just wondering if there's a balance on my account? I was pretty sure I was supposed to get a bill for the next six months, but I'm afraid I might have missed it?	CheckAccountBalance
Yes. Let's go ahead and make things easier on me .	UpdatePaymentPreference
Well, maybe I should get the better plan? How do I, how do I go about changing it?	ChangePlan
And that we need to remove the dependent immediately.	RemoveDependent
Yeah, yeah. Rivertown. That's what I said. I need to change my password. Can't get in.	ResetPassword
Oh! You didn't hear me? I needed to change my password.	ResetPassword
Yeah, I need to cancel my plant.	CancelPlan
Hello? I just needed to-to cancel autopay?	CancelAutomaticBilling
#Um, I'm actually trying-trying to cancel the account?	CancelPlan
Alright, Tony I don't see you in our database but you would like to be added to an insurance plan, yes?	EnrollInPlan
I've decided to open an account with you.	CreateAccount
Yes, yes. And I think we are going to go with the Home Complete package. No auto right now, but the Home Complete.	EnrollInPlan
Yes, I don't know what all that means, I just need to change this-this, internet billing.	CancelAutomaticBilling
#Uh, no? I just needed to change my payment preference.	UpdatePaymentPreference
No, no. I just wanted to switch it from withdrawing from my bank account-.	UpdatePaymentPreference
Hello? Yeah, I need to-to report an accident.	ReportAutomobileAccident
#Uh, yes? I called someone earlier about looking into pet insurance? His name was Mike?	GetQuote
I have my bills set up to be automatically deducted from my checking account on the first of every month and-.	UpdatePaymentPreference
Yes. I think the recurring payments to my card are damaging my credit? I just received a credit score, you know, one of those free ones they offer.	UpdatePaymentPreference
So Angela, I was wondering if there was a different way to pay?	UpdatePaymentPreference
Yes, hello. My name is Christen McDaniel. I have an auto insurance policy and I I needed to check up on a claim?	FileClaim
My truck. I need to save on my truck. Those jerks at Progressive are charging me an arm and a leg.	GetQuote
Hey Caroline, I'm back. Had to put out the dogs. Okay. Let's do that basic one.	EnrollInPlan
Oh, thank god! Yes! Okay. Yeah, that's me totally. Can we kick him off? .	RemoveDependent
#Uh, and you said-you said earlier you wanted to change the security question?	ChangeSecurityQuestion
Yeah, hi I need to report a car accident.	ReportAutomobileAccident
Great! So I'm just going to go ahead and create an account for you. So, your name is Karen Oldswold?	CreateAccount
Good morning! I just needed to add a person to my policy?	AddDependent
Yes, let's just do that. And then the mailed bill will come at the regular time?	PayBill
Well, I needed to cancel one of my insurance plans.	CancelPlan
I need to reset my password.	ResetPassword
Hi, yes, I'm calling today Id like to pay my bill. I always pay the same day my rent is due.	PayBill
Ive been charged twice for last months service. So I want to cancel automatic billing and just do it by hand.	ReportBillingIssue
Well yes, then, thats what I want to do. Cancel it permanently.	CancelAutomaticBilling
Um, yeah. Id like to report an accident.	ReportAutomobileAccident
Why don't we get your claim started and Ill advise you after weve submitted it.	FileClaim
I have some questions about adding a dependent to my health insurance policy. My daughter is living across town and shes currently not employed, so I'm helping her through a rough patch. I wondered if Id be able to add her to my health insurance. I don't want to see anything happen to her, but if it does, I want to know shes covered.	AddDependent
Yes, we get you insured and see to it you have fun while you're doing it. Did you want to pay that now?	PayBill
Hi. I think I want to get pet insurance for my cat. I don't know if I want to get it, but I think I want to get it. Hes healthy right now, but you never know when things could go wrong, you know.	EnrollInPlan
I want to sign up for a the health insurance plan you offer. It's time to take better care of myself.	EnrollInPlan
Yes, hi, my name is Summer. And I think I need insurance.	EnrollInPlan
Well, how much is once? I mean, like, how much do I pay if I pay once?	GetQuote
I do have some nice cameras. I wasn't even thinking of those. Maybe Id better go with the preferred after all.	EnrollInPlan
Well, what I'm actually calling about is I wanted to know if you're going to reopen or not and I wanted to change my address.	ChangeAddress
Hi Amy, Macy Nolan calling. I am not sure what I need to do but my bank, they said they need me to prove that I have insurance and the papers I have aren't good enough.	RequestProofOfInsurance
Actually, you know what? I think I have a payment due.	CheckPaymentStatus
Hi Adam, I need to remove the automatic payment thing from my account.	CancelAutomaticBilling
Hi, we moved and I want to tell you my new address so you have that.	ChangeAddress
I'd like to change my password, please.	ResetPassword
Hello Jenny, I'd like to cancel my plan.	CancelPlan
Hi there. I just bought a condo so I need some insurance. Can you help me with that? Or do I.	EnrollInPlan
I guess. How much is it?	GetQuote
Hi. I was wondering I want to need to create an account.	CreateAccount
I'm looking for new car insurance for my n- new car.	EnrollInPlan
Awesome. In order to begi- #eh complete your request we just need to create your account and pay- payment arrangements.	CreateAccount
Hi, David, my name is Marvin Wisniewski, and I need to get my policy number.	GetPolicyNumber
D you want to go ahead and remove her from the plan today?	RemoveDependent
Nah well maybe not now I don't think I need my renters insurance 	CancelPlan
So you had said you wanted to enroll in Petcare Preferred plan? Did you take a look at those quotes I emailed?	EnrollInPlan
Likewise I was calling because I was thinking of making changes to my plan 	ChangePlan
Yep. I actually called to cancel the plan.	CancelPlan
#Um hey this is Mark I wanted to get a pet quote and also can you help me change to card payment?	GetQuote
Uh-huh, actually I already have one of the pet plans but I was thinking about upgrading, is there another tier for this plan?	ChangePlan
Uh-huh and what's the rate for the Petcare Perfect plan?	GetQuote
Oh great then yeah I wanna make an account then.	CreateAccount
Mhm I can get my car insurance quote over the phone right?	GetQuote
I need to add my sixteen year-old to my policy, unfortunately. 	AddDependent
Can I change my mailing address to a post office box?	ChangeAddress
Oh yes hello. I am trying to reset my password on my account and I keep getting an error message. Can you help me wth this?	ResetPassword
Eee I think I have my payment preference set to my checking account.	UpdatePaymentPreference
Eee yeah I'm leaving my apa-apartment next week 	ChangeAddress
Uh-huh I want to cancel my account today.	CancelPlan
Nah stop the charges.	CancelAutomaticBilling
Oh alright go ahead and charge me right now.	PayBill
Mhm this is Eric you guys do auto quotes right?	GetQuote
Hello is the only way to create my account online? or 	CreateAccount
Mhm do you want to enroll in one of our plans now?	EnrollInPlan
Oh yeah I want to do that instead.	EnrollInPlan
Hey girl I just got two cute lil pups and I wanted to get a pet insurance for them.	EnrollInPlan
Uh-huh yep could I get a quote through the phone or 	GetQuote
Mhm sounds nice. #Er I think this is the plan I want to go with.	EnrollInPlan
Hey Estaban this is Elrin Andrews I wanted to call to get at quote for car insurance.	GetQuote
Hey Monica I wanted to get a quote f-for my p-pet pet insurance.	GetQuote
Uh Hi. I just want to pay my bill.	PayBill
Ok cool. Yes I want to pay by card please. But can you remind me the balance please?	CheckAccountBalance
Mhm yes this is Andrew I'm calling because I was hoping you could help me make my account.	CreateAccount
Hiyah! #Um I recently lost my insurance card and I've been asked by my school to show proof of insurance.	RequestProofOfInsurance
Uh-huh I'm calling to enroll in a plan today.	EnrollInPlan
Mhm I forgot my password how do I 	ResetPassword
Were you looking to create an account?	CreateAccount
It's alright it's been a week but yeah I guess I should probably cancel the pet insurance right?	CancelPlan
Eee actually could I change my password while I'm here?	ResetPassword
Hello this is Alvero Alveres I am calling because I keep getting these auto bills on my card.	ReportBillingIssue
#Uh well yeah I obviously want it changed I'm tired of this stuff man. That's why I'm calling!	CancelAutomaticBilling
Of course sir. if you want to discuss our fees and rates would you like to make an account with us?	CreateAccount
Yep let's just go ahead and do it now.	CreateAccount
Mhm I do car insurance with you guys you do renters insurance too right?	GetQuote
Whoa I like that actually could I upgrade to that plan? Fifteen hundred a year right?	ChangePlan
#Um hi could I create an account and enroll in a #plan over the phone?	CreateAccount
Yay! Always good to be ahead of the competition, so did you want to go ahead and begin enrolling.	EnrollInPlan
#Er hi there Molly, I'm calling to see if I could change my address over the phone.	ChangeAddress
#Um hi there the other day I tried to log into my account but I couldn't remember my question.	ChangeSecurityQuestion
Eee yeah I think I want to change my plan 	ChangePlan
Thank you. #Um so you wanted to start and account with us as well ma'am?	CreateAccount
Mhm I already got a quote for renters insurance I just needed to enroll.	EnrollInPlan
#Um I wanted to get a q-quote for pet inurance.	GetQuote
Oh hi. Yes I need to I would like to file a report of damage to my house.	FileClaim
Mhm yeah I saw I could make my account over the phone? #Uh do you.	CreateAccount
Uh-huh that's right I already have your account pulled up we can go ahead with the quote.	GetQuote
#Hm could you get me a quote for that?	GetQuote
Yep hello h-how do I check my balance I can do it over the phone right?	CheckAccountBalance
Would you like to make a payment on th-this now?	PayBill
Yep I wanted to get an auto quote it said I could do that over the phone.	GetQuote
Uh-huh hello I'm going to be moving soon 	ChangeAddress
Mhm I'm a n-new customer 	CreateAccount
#Uh yeah I just got a joint bank account and I think I want to use it for payment I don't know.	UpdatePaymentPreference
So you wanted to cancel your plan ma'am?	CancelPlan
Oh Hi there. I am needing to pay my bill.	PayBill
Yep I just made my account and now it says call to enroll?	EnrollInPlan
Nah could I also get a quote over the phone?	GetQuote
I called some days back concerning the vehicle insurance plan.	EnrollInPlan
yeah, I'm actually calling because i need a copy of My DOI, i can't for the life of me remember where i kept the last one.	RequestProofOfInsurance
Yeah,...I'm calling in Respect to Opening an account With Your Company.	CreateAccount
Oh good, help me add my son.	AddDependent
O-kay so I now discovered that the transactions are sometimes over charged since i enrolled for a pet plan or so.	ReportBillingIssue
I'd like to file a life claim.	FileClaim
yeah, can I get in touch with a nearby insurance agent.	FindAgent
I would like to cancel my insurance plan.	CancelPlan
Please I need help changing my insurance plan.	ChangePlan
Well I was looking at my credit card statement last night. And I think I might have been double billed for my policy this past month? Can you check that for me?	ReportBillingIssue
I'd like to file a property claim.	FileClaim
yeah, I want to change my security question to my mother's maiden name.	ChangeSecurityQuestion
So i think i should exempt him from my own insurance plans because i would need every penny i can save.	RemoveDependent
So i would love to have my address changed pending the time i move back, will that be possible?	ChangeAddress
I can't seem to log into my account, it keeps saying incorrect password, I think I might have forgotten my password.	ResetPassword
Good morning Susan, I'm John William. Calling to get explicit information about your company and her insurance policies and offers as Id love to have an account with you.	CreateAccount
Absolutely great...I think I am on the right track cos Id like to get an insurance for my automobiles.	EnrollInPlan
I want to pay for my insurance bill.	PayBill
Yes, how do I make payment.	PayBill
I just got a new job that will require me to travel from this vicinity, I will like to ask if it's possible to change my address pending the time I return.	ChangeAddress
So I'd love to change my address pending when I'll move back, will that be possible?	ChangeAddress
So initially, when I was trying to get to you guys last week, I just wanted to change my address.	ChangeAddress
Yeah, but now I would like to cancel one of my plans too.	CancelPlan
I'm great thank you, I got to find out about Midas insurance company through a friend few days back and I heard you guys have great plans and I thought I should call to create an account and enroll in a plan.	CreateAccount
I got a deduction from my balance concerning a plan but I didn't initiate the payment and this deduction has actually ruined my plans.	ReportBillingIssue
Can I find a nearby insurance agent?	FindAgent
I'm having difficulty logging into my account, all I was getting was incorrect password, Does this mean I have forgotten my password?	ResetPassword
Y-yeah yeah, I mean no, my day's not going great. I'm calling to report an accident.	ReportAutomobileAccident
Yeah, so you can actually make a claim. Would you like to make one?	FileClaim
No problem, thank you, I will like to file a health claim.	FileClaim
m...yeah, please how can I find an agent in my environment.	FindAgent
Good morning Susan, I'm John William. Calling to get explicit information about your company and her insurance policies and offers as Id love to have an account with you.	CreateAccount
Absolutely great...I think I am on the right track cos Id like to get an insurance for my automobiles.	EnrollInPlan
I I'm a new customer and I want to enroll in an insurance plan.	EnrollInPlan
can you help me create an account?	CreateAccount
um...i need help removing a dependent from my insurance plan.	RemoveDependent
Can i switch from the yearly to the monthly?	UpdateBillingFrequency
So I want to cancel the auto insurance plan.	CancelPlan
Okay, great, so you want to enroll in the automobile plan?	EnrollInPlan
Hello. I need to report my change of address.	ChangeAddress
I want to enroll in a plan.	EnrollInPlan
yes...could you please help me make my first payment.	PayBill
Hi I would love to change the address on my insurance plan. I guess I have to make a call to change my address?	ChangeAddress
First i need to check my account balance then get clarity on how to report an automobile accident.	CheckAccountBalance
Okay, would you like to make a claim?	FileClaim
Yeah, that's exactly what I thought. So that costs how much?	GetQuote
Yeah, sure. I do. I for one do not like to wrap my head around sudden injuries, particularly from third parties, so I think I will go for the Complete Home Home Complete package, rather, yeah.	EnrollInPlan
I was discussing with a friend and she told me about how she was able to add a relative of hers to her plan, are you with me?	AddDependent
So i think i should exempt him from my own insurance plans because i would need every penny i can save.	RemoveDependent
Okay, I'm here, okay, I need to know abou- about, how much do y'all cost for my car insurance?	GetQuote
I'm Jack with Rivertown Insurance, I see you want to file a claim?	FileClaim
Can you help me?	FileClaim
Oh I'm doing good, who, is this the right person for I think I'm locked out of my account.	ResetPassword
Look I just wanted to- I was told my that I hadn't paid for- and I was trying to pay. They said I didn't.	PayBill
Wait what's this even going to cost me-.	GetQuote
Uh hi. I need to cancel my plan.	CancelPlan
Yep. yeah I've got- well we just move and yep I just need to you need my new address? Sorry I 	ChangeAddress
What? No sir, I'm calling because you wanted to add your son to your plan because he starts driving soon?	AddDependent
Hey man, so I called about that quote for my Forerunner, you know, for yea, for insurance?	GetQuote
Yes my - I need to I think my insurance payments went up.	ReportBillingIssue
Not that I can well we we have a son- a kid that's about to start driving, how do I get him insured, how does that work?	AddDependent
Hi, I I need to change my car insurance.	ChangePlan
Yeah I suppose I better add her on too.	AddDependent
Hi, my name is Maybelle Clearmont, I need to change my billing cycle.	UpdateBillingFrequency
Hey my name is Daniel Haygood. I tried logging into my account to see how my claim was going and I can't get in and now it says I'm locked out.	ResetPassword
Yes I'd like to cancel my policy.	CancelPlan
Oh. good. Finally got through. yeah I need to pay my bill.	PayBill
Ok fine I will be paying with my credit card. But first please remind me the balance due?	CheckAccountBalance
I'm good. I need to change my address with y'all.	ChangeAddress
Hey Brenda I need to set up some insurance.	EnrollInPlan
Yeah let's go ahead and pay it.	PayBill
[clears throat] My husband passed and I'm calling about his life insurance.	FileClaim
Hi. I'm calling to get a quote for life insurace.	GetQuote
Yes, let's get to it.	EnrollInPlan
I'm calling to find out if my payment went through.	CheckPaymentStatus
#Um, I can't remember my, didn't remember my password and tried too many times, now I'm locked out.	ResetPassword
I'm good, thanks. I'm calling back to enroll in a renters plan.	EnrollInPlan
Well, I called to cancel my insurance plan.	CancelPlan
I'm calling to change my security question.	ChangeSecurityQuestion
Right. It worried me. I thought it would best if I changed my password, too.	ResetPassword
#Um hi there my name's Susan, I was just trying to login to the website to check on my last payment, and I've had so many issues with the website lately, trying to log on and everything, so I thought I'd ring up and see if I could reset my password to fix it.	ResetPassword
#Um actually, am I able to just quickly check with you whether the payment on our last bill went through? It was the Renters Preferred package and I just wanted to confirm it had gone through.	CheckPaymentStatus
#Um I think for today it would be great if I could actually pay the August bill over the phone with you now, out of my checking account if possible because I know that will work. Do you take over the phone payment for bills?	PayBill
Uh hey there. I need to notify of my move my change of address.	ChangeAddress
Yes. Hi. Yeah, I'm calling to pay my bill.	PayBill
#Um, I don't know. Can I pay monthly?	UpdateBillingFrequency
Hi. I'm getting charged every six months for my auto insurance and I want to change it to monthly.	UpdateBillingFrequency
It's, oh, I also need to update my address.	ChangeAddress
Hi. #Um, I'm calling for, to get a quote for homeowners insurance.	GetQuote
#Oh, I understand. You need proof of insurance for your landlord?	RequestProofOfInsurance
Yeah. That's it. Proof of insurance.	RequestProofOfInsurance
Yeah, did my bill go through this month. I didn't see an email like I usually do.	CheckPaymentStatus
Uh, no. Homeowners.	FileClaim
Hi. I called last week for a quote and now I want to enroll in the plan.	EnrollInPlan
I need to check my balance.	CheckAccountBalance
#Oh. No, I was just wondering that if the balance for the rest of the six months wasn't too high, that I would pay it all now.	PayBill
Wait, I need the balance before I decide.	CheckAccountBalance
I need to add my daughter to my car insurance.	AddDependent
Hi. I'm calling to file a death benefit, life insurance, claim. .	FileClaim
Hey I need to change my payment method. I am getting paper bills in the mail and I want to set up a payment throught like my card? My credit card?	UpdatePaymentPreference
Hi. I'm calling to, well, I already have insurance, but I'm looking for something cheaper.	GetQuote
Hi, Andy? #Um, I need to pay my bill.	PayBill
I need to reset my password and I wasn't able to do it online. My account my be locked?	ResetPassword
Hi. I can't find my policy number and need it for my bank.	GetPolicyNumber
Ok. Thanks. What about the proof that I have the policy?	RequestProofOfInsurance
Hey. I'm calling to change my security info. I keep forgetting the answers and I keep getting locked out.	ChangeSecurityQuestion
Uh, I can't find my policy and I need proof of insurance.	RequestProofOfInsurance
I need to remove her name.	RemoveDependent
I have a friend, who, told me about it and I have a dog, a Doodle, and wanted to get some coverage for her.	EnrollInPlan
Well, I just got a puppy and was hoping I could sign up for pet insurance and a friend told me you guys do this.	EnrollInPlan
Hi there. I'm calling because I need to remove my son from our, my life insurance.	RemoveDependent
Good. Then let's go with that one.	EnrollInPlan
I need to work on getting car insurance and I'm calling around to get quotes.	GetQuote
Hi. #Um, well, I'm calling because I have no fence as of yesterday and I need to get it fixed right away.	FileClaim
Hi. Well, I signed up for pet insurance last month and I noticed my bill's kinda high. I'm not sure what's going on.	ReportBillingIssue
Yes. Yes, he wants to change plans. So.	ChangePlan
Hey there. I'm calling about changing my plan.	ChangePlan
Hi. Um, I'm calling to get a quote for auto insurance.	GetQuote
Ok. Let's go with monthly.	UpdateBillingFrequency
Yeah. Um, let's do it. My other insurance is like twenty dollars more a month.	EnrollInPlan
Hi. I need to start a claim for my car.	FileClaim
Right. Ok, I'll sign up for that one.	EnrollInPlan
I need to change my card on file. I just got a new one.	UpdatePaymentPreference
Hi yes I need to purchase some pet insurance.	EnrollInPlan
Well, I got this email that says, well I get my payments, are made, they're automatic and I noticed the payment was higher than usualy, so I went online, and saw a weird charge.	ReportBillingIssue
Well, yes! I didn't sign up for it.	CancelPlan
#Um. I'm calling to see if my payment went through.	CheckPaymentStatus
Well, it's not a problem. We can process the remaining payment now if you'd like.	PayBill
Hi. My name is Mason. I'm calling to find out how much your condo insurance is.	GetQuote
Alright. Would you like to enroll today or I can send the quote to an email address for you.	EnrollInPlan
Hi. #Uh, I have renters insurance with you guys and need to put in a claim.	FileClaim
So you need proof of insurance?	RequestProofOfInsurance
I got your policy reinstated, but you'll need to pay for the past two months and the late fees to bring your policy to a fully paid status.	PayBill
#Um, hi. I need to cancel my life insurance.	CancelPlan
Hang on a second. I made a little budget for myself. Let me see if I can swing this. One sec.	ChangePlan
Well, I'm calling to pay my bill.	PayBill
No, I just have a different card I want to use this month.	UpdatePaymentPreference
Well, I'm mad, because I keep getting the same error on my bill every month.	ReportBillingIssue
Thanks for calling Rivertown Insurance. My name is Allison and I work in the claims department. Did you need to open a claim today?	FileClaim
I was needing to take my kid off of our healthcare plan.	RemoveDependent
Hi. I'm having a tough time trying to find my balance on my life insurance.	CheckAccountBalance
Hi. #Um, I'm calling to set up an account.	CreateAccount
I need to file a claim.	FileClaim
#Um, well, sorry, but I need to cancel my plan.	CancelPlan
#Um, while I'm away, my stuff will be in storage and I need to change my renters insurance a little. Can I do that now?	ChangePlan
Thanks. They also said I need to provide proof of renters. Would the email work?	RequestProofOfInsurance
I'm calling to change my address.	ChangeAddress
Hi. I'm call to add my son to my auto policy.	AddDependent
I need to change my plan, auto plan.	ChangePlan
#Uh, just to have my proof of insurance for my bank.	RequestProofOfInsurance
It's for my new car, but the bank said they didn't receive the policy number from me even though I thought I added it to the loan paperwork.	GetPolicyNumber
Hi there. I am needing to let someone know my new address. I just moved and want to update my information.	ChangeAddress
Uh well I moved. So my address.	ChangeAddress
Hi. I want to cancel my automatic payments.	CancelAutomaticBilling
#Um, yes, hi. I would, need help with creating my account, I enrolled a few days ago. Actually it was, I think last Thursday, on the twenty seventh.	CreateAccount
I recently moved from my previous residence and would like to get my residence address updated.	ChangeAddress
Okay then. I'll go ahead and do just that.	RemoveDependent
Yeah thanks. So yeah I just lost my dad and I'm calling to file a life claim.	FileClaim
I was a dependent of my dad's health insurance policy. I would like to open up an account now that he's gone.	EnrollInPlan
